Transaction ID,Posting Date,Effective Date,Transaction Type,Amount,Check Number,Reference Number,Description,Transaction Category,Type,Balance,Memo,Extended Description
,10/1/2023,,Debit,-29.99,,66007973,Payment to Comcast,Cable & Satellite,,174.66,,Bill payment Withdrawal COMCAST DENVER 4899 800-266-2278 CO
,9/28/2023,,Debit,-18.02,,65798760,Wendy's,Restaurants & Dining,Debit Card,204.65,,POS Card purchase WENDY'S 8028 5814 565 WALTON BLVD LAS CRUCES NM
,9/28/2023,,Debit,-3.19,,65788798,Supercell,Entertainment,Debit Card,222.67,,Debit Card purchase GOOGLE *SUPERCELL 5818 G.CO/HELPPAY# CA
,9/28/2023,,Debit,-10.65,,65788797,Supercell,Entertainment,Debit Card,225.86,,Debit Card purchase GOOGLE *SUPERCELL 5818 G.CO/HELPPAY# CA
,9/28/2023,,Debit,-5.32,,65788796,Supercell,Entertainment,Debit Card,236.51,,Debit Card purchase GOOGLE *SUPERCELL 5818 G.CO/HELPPAY# CA
,9/28/2023,,Debit,-19.35,,65788795,McDonald's,Restaurants & Dining,Debit Card,241.83,,Debit Card purchase MCDONALD'S F20533 5814 LAS CRUCES NM
,9/27/2023,,Debit,-18.89,,65735588,Raising Cane's,Restaurants & Dining,Debit Card,261.18,,Debit Card purchase RAISING CANES 0340 5814 LAS CRUCES NM
,9/27/2023,,Debit,-5.63,,65735587,Einstein Bros. Bagels,Restaurants & Dining,Debit Card,280.07,,Debit Card purchase EINSTEINS CCSU 5814 LAS CRUCES NM
,9/25/2023,,Debit,-20.13,,65662338,Whataburger,Restaurants & Dining,Debit Card,285.7,,Debit Card purchase WHATABURGER 465 5814 LAS CRUCES NM
,9/25/2023,,Debit,-12.82,,65662339,ACH Withdrawal COMPANY: CRUNCH FIT ENTRY: CLUB FEES XX-8030 ISAIAH MALCON,Personal Care & Fitness,,305.83,,ACH Withdrawal COMPANY: CRUNCH FIT ENTRY: CLUB FEES 505-387-8030 ISAIAH MALCON
,9/23/2023,,Credit,300,,65538635,Transfer from Zelle,Transfers,,318.65,,Shared branch Deposit ZELLE 6532
,9/23/2023,,Debit,-8.43,,65538634,Starbucks,Restaurants & Dining,Debit Card,18.65,,Debit Card purchase STARBUCKS STORE 11645 5814 LAS CRUCES NM
,9/22/2023,,Debit,-29.21,,65505096,Supercuts,Personal Care & Fitness,Debit Card,27.08,,Debit Card purchase SUPERCUTS 7298 LAS CRUCES NM
,9/22/2023,,Debit,-53.05,,65486285,Walmart,Shopping,Debit Card,56.29,,POS Card purchase WAL-MART SUPER CENTER 5411 0806 WAL-SAMS LAS CRUCES NM
,9/22/2023,,Debit,-100,,65484887,Online banking Withdrawal Transfer to LXX00 - Credit Card,Credit Card Payments,Transfer,109.34,,Online banking Withdrawal Transfer to L0100 - Credit Card Payment
,9/22/2023,,Debit,-300,,65484856,Transfer to Zelle,Transfers,,209.34,,Shared branch Withdrawal ZELLE 6532
,9/22/2023,,Debit,-16.47,,65480601,Raising Cane's,Restaurants & Dining,Debit Card,509.34,,Debit Card purchase RAISING CANES 0340 5814 LAS CRUCES NM
,9/21/2023,,Credit,147.38,,65443295,Debit Deposit VENMO*MALCOM ISAIAH 4829 NEW YORK CITY NY,Transfers,,525.81,,Debit Deposit VENMO*MALCOM ISAIAH 4829 NEW YORK CITY NY
,9/19/2023,,Debit,-30,,65308247,Abc Fitness Service Charges/Fees,Service Charges & Fees,Fees,378.43,,Fee Withdrawal COMPANY: ABC FITNESS ENTRY: CLUBCHARGE E091623A ISAIAH MALCON - NSF Fee
,9/18/2023,,Debit,-21.6,,65250056,Adobe Creative Cloud,Online Services,,408.43,,Bill payment Withdrawal ADOBE *CREATIVE CLOUD 5734 408-536-6000 CA
,9/18/2023,,Debit,-10.82,,65250055,Planet Fitness,Personal Care & Fitness,,430.03,,ACH Withdrawal COMPANY: PLANET FIT ENTRY: CLUB FEES 575-522-7867 ISAIAH MALCOM
,9/17/2023,,Debit,-11.99,,65250054,HOSTINGER* HOSTINGER.C 7372 KAUNAS LT,Online Services,Debit Card,440.85,,Debit Card purchase HOSTINGER* HOSTINGER.C 7372 KAUNAS LT
,9/15/2023,,Debit,-27.7,,65114267,Village Inn,Restaurants & Dining,Debit Card,452.84,,Debit Card purchase VILLAGE INN PANCAKE HO 5812 LAS CRUCES NM
,9/15/2023,,Debit,-14.04,,65114266,Village Inn,Restaurants & Dining,Debit Card,480.54,,Debit Card purchase VILLAGE INN PANCAKE HO 5812 LAS CRUCES NM
,9/15/2023,,Debit,-5.75,,65106274,Aggie Car Wash,Automotive Expenses,Debit Card,494.58,,Debit Card purchase AGGIE CARWASH 7542 LAS CRUCES NM
,9/15/2023,,Debit,-5.86,,65106273,YouTube Music,Entertainment,Debit Card,500.33,,Debit Card purchase GOOGLE *YOUTUBE MUSIC 5815 G.CO/HELPPAY# CA
,9/14/2023,,Credit,388.81,,65067422,ATM Deposit CU ANYTIME XX 1715 EAST UNIVERSITY LAS CRUCES NM,Deposits,,506.19,,ATM Deposit CU ANYTIME 6011 1715 EAST UNIVERSITY LAS CRUCES NM
,9/14/2023,,Credit,147.38,,65042621,Debit Deposit VENMO*MALCOM ISAIAH 4829 NEW YORK CITY NY,Transfers,,117.38,,Debit Deposit VENMO*MALCOM ISAIAH 4829 NEW YORK CITY NY
,9/14/2023,,Debit,-30,,65042620,Abc Fitness Service Charges/Fees,Service Charges & Fees,Fees,-30,,Fee Withdrawal COMPANY: ABC FITNESS ENTRY: CLUBCHARGE E091323A ISAIAH MALCON - NSF Fee
,9/12/2023,,Debit,-13.39,,65003867,Blake's Lotaburger,Restaurants & Dining,Debit Card,0,,Debit Card purchase BLAKE S LOTABURGER - 028 5814 LAS CRUCES NM
,9/12/2023,,Debit,-49.99,,65003866,Payment to Comcast,Cable & Satellite,,13.39,,Bill payment Withdrawal COMCAST CABLE COMM 4899 800-COMCAST CO
,9/11/2023,,Debit,-30.84,,65003865,Sam's Club,Shopping,Debit Card,63.38,,POS Card purchase SAMS CLUB #4784 5542 SAM'S CLUB LAS CRUCES NM
,9/11/2023,,Debit,-16.25,,64903456,Raising Cane's,Restaurants & Dining,Debit Card,94.22,,Debit Card purchase RAISING CANES 0340 5814 LAS CRUCES NM
,9/11/2023,,Debit,-8.43,,64877932,Starbucks,Restaurants & Dining,Debit Card,110.47,,Debit Card purchase STARBUCKS STORE 11645 5814 LAS CRUCES NM
,9/11/2023,,Debit,-30,,64877934,Abc Fitness Service Charges/Fees,Service Charges & Fees,Fees,118.9,,Fee Withdrawal COMPANY: ABC FITNESS ENTRY: CLUBCHARGE E090823A ISAIAH MALCON - NSF Fee
,9/10/2023,,Debit,-30.92,,64877933,TST* BOSQUE BREWING COMPA 5813 LAS CRUCES NM,Restaurants & Dining,Debit Card,148.9,,Debit Card purchase TST* BOSQUE BREWING COMPA 5813 LAS CRUCES NM
,9/9/2023,,Debit,-67.88,,64799271,Walmart,Shopping,Debit Card,179.82,,POS Card purchase WM SUPERCENTER #806 5411 WAL-MART SUPER CENTER LAS CRUCES NM
,9/9/2023,,Debit,-147.32,,64799270,The Home Depot,Home Supplies,Debit Card,247.7,,POS Card purchase THE HOME DEPOT #3505 5200 225 TELSHORE BLVD LAS CRUCES NM
,9/9/2023,,Debit,-10.8,,64788737,Wendy's,Restaurants & Dining,Debit Card,395.02,,POS Card purchase WENDY'S 8028 5814 565 WALTON BLVD LAS CRUCES NM
,9/8/2023,,Credit,435.14,,64739688,ACH Deposit COMPANY: RENEW ELECTRIC L ENTRY: PAYROLL ISAIAH MALCOM,Paychecks/Salary,ACH,405.82,,ACH Deposit COMPANY: RENEW ELECTRIC L ENTRY: PAYROLL ISAIAH MALCOM
,9/6/2023,,Debit,-30,,64611945,Abc Fitness Service Charges/Fees,Service Charges & Fees,Fees,-29.32,,Fee Withdrawal COMPANY: ABC FITNESS ENTRY: CLUBCHARGE E090223A ISAIAH MALCON - NSF Fee
,9/4/2023,,Debit,-100,,64469172,Online banking Withdrawal Transfer to LXX00 - Credit Card,Credit Card Payments,Transfer,0.68,,Online banking Withdrawal Transfer to L0100 - Credit Card Payment
,9/1/2023,,Debit,-320,,64353042,Online banking Withdrawal Transfer to LXX00 - Credit Card,Credit Card Payments,Transfer,100.68,,Online banking Withdrawal Transfer to L0100 - Credit Card Payment
,9/1/2023,,Credit,427.52,,64346985,ACH Deposit COMPANY: RENEW ELECTRIC L ENTRY: PAYROLL ISAIAH MALCOM,Paychecks/Salary,ACH,420.68,,ACH Deposit COMPANY: RENEW ELECTRIC L ENTRY: PAYROLL ISAIAH MALCOM
,8/31/2023,,Debit,-30,,64259445,Abc Fitness Service Charges/Fees,Service Charges & Fees,Fees,-6.84,,Fee Withdrawal COMPANY: ABC FITNESS ENTRY: CLUBCHARGE E083023A ISAIAH MALCON - NSF Fee
,8/28/2023,,Debit,-30,,64115639,Abc Fitness Service Charges/Fees,Service Charges & Fees,Fees,23.16,,Fee Withdrawal COMPANY: ABC FITNESS ENTRY: CLUBCHARGE E082523A ISAIAH MALCON - NSF Fee
,8/26/2023,,Debit,-24.53,,63999456,Dion's,Restaurants & Dining,Debit Card,53.16,,Debit Card purchase DIONS 18 5812 LAS CRUCES NM
,8/25/2023,,Debit,-43.69,,63943383,Sam's Club,Shopping,Debit Card,77.69,,POS Card purchase SAMS CLUB #4784 5542 SAM'S CLUB LAS CRUCES NM
,8/25/2023,,Debit,-400,,63937890,Online banking Withdrawal Transfer to LXX00 - Credit Card,Credit Card Payments,Transfer,121.38,,Online banking Withdrawal Transfer to L0100 - Credit Card Payment
,8/25/2023,,Credit,404.48,,63937854,ACH Deposit COMPANY: RENEW ELECTRIC L ENTRY: PAYROLL ISAIAH MALCOM,Paychecks/Salary,ACH,521.38,,ACH Deposit COMPANY: RENEW ELECTRIC L ENTRY: PAYROLL ISAIAH MALCOM
,8/22/2023,,Debit,-21.6,,63829068,Adobe Creative Cloud,Online Services,,116.9,,Bill payment Withdrawal ADOBE CREATIVE CLOUD 5734 408-536-6000 CA
,8/21/2023,,Credit,50,,63664510,Transfer from Zelle,Transfers,,138.5,,Shared branch Deposit ZELLE 6532
,8/20/2023,,Debit,-58,,63658141,Dave & Buster's,Restaurants & Dining,Debit Card,88.5,,Debit Card purchase DAVE & BUSTER'S #92 5812 EL PASO TX
,8/20/2023,,Debit,-24.9,,63641936,RENTACHEFELPASO 5811 EL PASO TX,Rent,Debit Card,146.5,,Debit Card purchase RENTACHEFELPASO 5811 EL PASO TX
,8/20/2023,,Debit,-26.77,,63641935,Rockstar Burger Bar,Restaurants & Dining,Debit Card,171.4,,Debit Card purchase TST* ROCKSTAR BURGER BAR 5812 EL PASO TX
,8/20/2023,,Debit,-8.5,,63641934,Rockstar Burger Bar,Restaurants & Dining,Debit Card,198.17,,Debit Card purchase TST* ROCKSTAR BURGER BAR 5812 EL PASO TX
,8/20/2023,,Debit,-15,,63641933,DIVERSIFIED PARKING INC 7523 EL PASO TX,Travel & Commute,Debit Card,206.67,,Debit Card purchase DIVERSIFIED PARKING INC 7523 EL PASO TX
,8/20/2023,,Debit,-9.9,,63641932,Amazon,Shopping,Debit Card,221.67,,Debit Card purchase AMAZON.COM*TQ0707MN2 5942 AMZN.COM/BILL WA
,8/20/2023,,Debit,-87,,63620531,Online banking Withdrawal Transfer to LXX00 - Credit Card,Credit Card Payments,Transfer,231.57,,Online banking Withdrawal Transfer to L0100 - Credit Card Payment
,8/19/2023,,Debit,-12.63,,63603413,Whataburger,Restaurants & Dining,Debit Card,318.57,,Debit Card purchase WHATABURGER 465 5814 LAS CRUCES NM
,8/19/2023,,Debit,-27,,63603415,AMZN MKTP US*TQ0366ZZ0 5942 AMZN.COM/BILL WA,Shopping,Debit Card,331.2,,Debit Card purchase AMZN MKTP US*TQ0366ZZ0 5942 AMZN.COM/BILL WA
,8/19/2023,,Debit,-3.29,,63603414,Speedway,Gasoline/Fuel,Debit Card,358.2,,Debit Card purchase SPEEDWAY 09128 1685 E. UN 5541 LAS CRUCES NM
,8/19/2023,,Credit,260,,63577285,ATM Deposit CU ANYTIME 6011 1600S VALLEY DR LAS CRUCES NM,Deposits,,361.49,,ATM Deposit CU ANYTIME 6011 1600S VALLEY DR LAS CRUCES NM
,8/19/2023,,Debit,-8.49,,63577214,Circle K,Groceries,Debit Card,101.49,,Debit Card purchase CIRCLE K 06001 5499 LAS CRUCES NM
,8/18/2023,,Debit,-11.99,,63577213,HOSTINGER* HOSTINGER.C 7372 KAUNAS LT,Online Services,Debit Card,109.98,,Debit Card purchase HOSTINGER* HOSTINGER.C 7372 KAUNAS LT
,8/18/2023,,Debit,-300,,63552819,Online banking Withdrawal Transfer to LXX00 - Credit Card,Credit Card Payments,Transfer,121.97,,Online banking Withdrawal Transfer to L0100 - Credit Card Payment
,8/18/2023,,Debit,-17.96,,63552495,Walmart,Shopping,Debit Card,421.97,,POS Card purchase WAL-MART #0806 5411 571 WALTON BLVD LAS CRUCES NM
,8/18/2023,,Debit,-6.5,,63552496,Aggie Car Wash,Automotive Expenses,Debit Card,439.93,,Debit Card purchase AGGIE CARWASH 7542 LAS CRUCES NM
,8/18/2023,,Credit,433.14,,63534426,ACH Deposit COMPANY: RENEW ELECTRIC L ENTRY: PAYROLL ISAIAH MALCOM,Paychecks/Salary,ACH,446.43,,ACH Deposit COMPANY: RENEW ELECTRIC L ENTRY: PAYROLL ISAIAH MALCOM
,8/17/2023,,Debit,-10.82,,63483254,Planet Fitness,Personal Care & Fitness,,13.29,,ACH Withdrawal COMPANY: PLANET FIT ENTRY: CLUB FEES 575-522-7867 ISAIAH MALCOM
,8/17/2023,,Debit,-10.79,,63463323,Circle K,Groceries,Debit Card,24.11,,Debit Card purchase CIRCLE K 06001 5499 LAS CRUCES NM
,8/13/2023,,Debit,-15.97,,63327898,Wendy's,Restaurants & Dining,Debit Card,34.9,,POS Card purchase WENDY'S 8028 5814 565 WALTON BLVD LAS CRUCES NM
,8/13/2023,,Debit,-5.32,,63271521,YouTube Music,Entertainment,Debit Card,50.87,,Debit Card purchase GOOGLE *YOUTUBE MUSIC 7829 G.CO/HELPPAY# CA
,8/12/2023,,Debit,-16.7,,63237167,Raising Cane's,Restaurants & Dining,Debit Card,56.19,,Debit Card purchase RAISING CANES 0340 5814 LAS CRUCES NM
,8/11/2023,,Debit,-9.25,,63237166,Aggie Car Wash,Automotive Expenses,Debit Card,72.89,,Debit Card purchase AGGIE CARWASH 7542 LAS CRUCES NM
,8/11/2023,,Debit,-300,,63177242,Online banking Withdrawal Transfer to LXX00 - Credit Card,Credit Card Payments,Transfer,82.14,,Online banking Withdrawal Transfer to L0100 - Credit Card Payment
,8/11/2023,,Credit,370.49,,63156018,ACH Deposit COMPANY: RENEW ELECTRIC L ENTRY: PAYROLL ISAIAH MALCOM,Paychecks/Salary,ACH,382.14,,ACH Deposit COMPANY: RENEW ELECTRIC L ENTRY: PAYROLL ISAIAH MALCOM
,8/5/2023,,Debit,-16.19,,62842374,Blake's Lotaburger,Restaurants & Dining,Debit Card,11.65,,Debit Card purchase BLAKE S LOTABURGER - 033 5814 LAS CRUCES NM
,8/5/2023,,Debit,-50,,62842372,WELLS FARGO C/A #XX 6010 LAS CRUCES NM,Other Expenses,Debit Card,27.84,,Debit Card purchase WELLS FARGO C/A #005388 6010 LAS CRUCES NM
,8/5/2023,,Debit,-8.53,,62842373,Caliche's Frozen Custard,Restaurants & Dining,Debit Card,77.84,,Debit Card purchase CALICHES FROZEN CUSTARD 5814 LAS CRUCES NM
,8/4/2023,,Debit,-2.25,,62798207,Aggie Car Wash,Automotive Expenses,Debit Card,86.37,,Debit Card purchase AGGIE CARWASH 7542 LAS CRUCES NM
,8/3/2023,,Debit,-400,,62742074,Online banking Withdrawal Transfer to LXX00 - Credit Card,Credit Card Payments,Transfer,88.62,,Online banking Withdrawal Transfer to L0100 - Credit Card Payment
,8/3/2023,,Credit,488.12,,62742039,Check Deposit,Deposits,Deposit,488.62,,Check Deposit
,8/2/2023,,Debit,-21.5,,62704179,McDonald's,Restaurants & Dining,Debit Card,0.5,,Debit Card purchase MCDONALD'S F6849 5814 LAS CRUCES NM
,8/2/2023,,Debit,-92,,62639702,Online banking Withdrawal Transfer to LXX00 - Credit Card,Credit Card Payments,Transfer,22,,Online banking Withdrawal Transfer to L0100 - Credit Card Payment
,8/1/2023,,Credit,14,,62638133,ATM Deposit CU ANYTIME 6011 1600S VALLEY DR LAS CRUCES NM,Deposits,,114,,ATM Deposit CU ANYTIME 6011 1600S VALLEY DR LAS CRUCES NM
,8/1/2023,,Credit,100,,62638132,ATM Deposit CU ANYTIME 6011 1600S VALLEY DR LAS CRUCES NM,Deposits,,100,,ATM Deposit CU ANYTIME 6011 1600S VALLEY DR LAS CRUCES NM
,8/1/2023,,Debit,-0.73,,62625187,McDonald's,Restaurants & Dining,Debit Card,0,,POS Card purchase MCDONALD'S F20533 5814 1751 E UNIVERSITY AVE LAS CRUCES NM
,8/1/2023,,Debit,-30,,62575410,Online banking Withdrawal Transfer to LXX00 - Credit Card,Credit Card Payments,Transfer,0.73,,Online banking Withdrawal Transfer to L0100 - Credit Card Payment
,8/1/2023,,Debit,-7.45,,62575230,Caliche's Frozen Custard,Restaurants & Dining,Debit Card,30.73,,Debit Card purchase CALICHES FROZEN CUSTARD 5814 LAS CRUCES NM
,7/31/2023,,Debit,-78.22,,62575229,The Home Depot,Home Supplies,Debit Card,38.18,,POS Card purchase THE HOME DEPOT #3505 5200 225 TELSHORE BLVD LAS CRUCES NM
,7/31/2023,,Credit,100,,62548879,Credit Card Payment Received,Credit Card Payments,Transfer,116.4,,Online banking Deposit Transfer from S0000
,7/31/2023,,Debit,-46.34,,62548819,RIB HUT 5812 EL PASO TX,Restaurants & Dining,Debit Card,16.4,,Debit Card purchase RIB HUT 5812 EL PASO TX
,7/31/2023,,Debit,-10,,62502384,MUSTANG FRANKLIN 7523 DALLAS TX,Restaurants & Dining,Debit Card,62.74,,Debit Card purchase MUSTANG FRANKLIN 7523 DALLAS TX
,7/30/2023,,Debit,-22.92,,62463825,WingHouse,Restaurants & Dining,Debit Card,72.74,,Debit Card purchase EL PASO WING HOUSE 5812 EL PASO TX
,7/30/2023,,Debit,-39.43,,62463824,Speedway,Gasoline/Fuel,Debit Card,95.66,,Debit Card purchase SPEEDWAY 09128 1685 E. UN 5542 LAS CRUCES NM
,7/29/2023,,Credit,98.25,,62442692,Debit Deposit VENMO*MALCOM ISAIAH 4829 NEW YORK CITY NY,Transfers,,135.09,,Debit Deposit VENMO*MALCOM ISAIAH 4829 NEW YORK CITY NY
,7/29/2023,,Debit,-92.93,,62442062,Payment to U-Haul,Rent,Debit Card,36.84,,Debit Card purchase U-HAUL MOVING & STORAGE A 7513 LAS CRUCES NM
,7/29/2023,,Debit,-3.29,,62433357,Speedway,Gasoline/Fuel,Debit Card,129.77,,Debit Card purchase SPEEDWAY 09128 1685 E. UN 5541 LAS CRUCES NM
,7/29/2023,,Debit,-13.08,,62433355,McDonald's,Restaurants & Dining,Debit Card,133.06,,Debit Card purchase MCDONALD'S F20533 5814 LAS CRUCES NM
,7/28/2023,,Debit,-3.32,,62433356,Phillips 66,Gasoline/Fuel,Debit Card,146.14,,Debit Card purchase PHILLIPS 66 - KEWA GAS 1 5541 SANTO DOMINGO NM
,7/28/2023,,Credit,49.7,,62389997,AutoZone,Automotive Expenses,Debit Card,149.46,,POS Card purchase return Adjustment AUTOZONE 02502 5533 1425 S EL PASEO RD LAS CRUCES NM
,7/28/2023,,Debit,-11.65,,62378843,Marathon Petroleum,Gasoline/Fuel,Debit Card,99.76,,Debit Card purchase MARATHON PETRO235069 5541 LEMITAR NM
,7/28/2023,,Debit,-32.4,,62378842,Payment to U-Haul,Rent,Debit Card,111.41,,Debit Card purchase U-HAUL MOVING & STORAGE A 5999 LAS CRUCES NM
,7/28/2023,,Debit,-72.69,,62378841,Road Runner Sports,Shopping,Debit Card,143.81,,Debit Card purchase ROADRUNNER 5541 LEMITAR NM
,7/28/2023,,Debit,-72.5,,62364927,Kewa Gas,Gasoline/Fuel,Debit Card,216.5,,POS Card purchase KEWA GAS 2 5542 HWY 22 W US SANTO DOMINGO NM
,7/27/2023,,Debit,-16.39,,62364926,Taco Bell,Restaurants & Dining,Debit Card,289,,Debit Card purchase TACO BELL 001600167551 5814 LAS CRUCES NM
,7/27/2023,,Debit,-330.63,,62284516,Harbor Freight Tools,Home Supplies,Debit Card,305.39,,Debit Card purchase HARBOR FREIGHT TOOLS 236 5251 LAS CRUCES NM
,7/26/2023,,Debit,-49.7,,62284515,AutoZone,Automotive Expenses,Debit Card,636.02,,POS Card purchase AUTOZONE 02502 5533 1425 S EL PASEO RD LAS CRUCES NM
,7/26/2023,,Credit,491.25,,62239324,Debit Deposit VENMO*MALCOM ISAIAH 4829 NEW YORK CITY NY,Transfers,,685.72,,Debit Deposit VENMO*MALCOM ISAIAH 4829 NEW YORK CITY NY
,7/24/2023,,Credit,200,,62139562,Cash Deposit,Deposits,Deposit,194.47,,Cash Deposit
,7/23/2023,,Debit,-16.7,,62094565,Raising Cane's,Restaurants & Dining,Debit Card,-5.53,,Debit Card purchase RAISING CANES 0340 5814 LAS CRUCES NM
,7/23/2023,,Debit,-32.23,,62068140,Speedway,Gasoline/Fuel,Debit Card,11.17,,Debit Card purchase SPEEDWAY 09128 1685 E. UN 5542 LAS CRUCES NM
,7/22/2023,,Debit,-39.1,,62026773,TST* MOOSES DRAFT HOUSE 5813 EL PASO TX,Restaurants & Dining,Debit Card,43.4,,Debit Card purchase TST* MOOSES DRAFT HOUSE 5813 EL PASO TX
,7/22/2023,,Debit,-16.29,,62026772,Amazon,Shopping,,82.5,,Bill payment Withdrawal AMAZON PRIME*GA8WU5AH3 5968 AMZN.COM/BILL WA
,7/22/2023,,Credit,49.13,,62014323,Debit Deposit VENMO*MALCOM ISAIAH 4829 NEW YORK CITY NY,Transfers,,98.79,,Debit Deposit VENMO*MALCOM ISAIAH 4829 NEW YORK CITY NY
,7/21/2023,,Debit,-9.44,,62005849,Whataburger,Restaurants & Dining,Debit Card,49.66,,Debit Card purchase WHATABURGER 465 5814 LAS CRUCES NM
,7/20/2023,,Debit,-11.23,,61962723,Wendy's,Restaurants & Dining,Debit Card,59.1,,POS Card purchase WENDY'S 8028 5814 565 WALTON BLVD LAS CRUCES NM
,7/20/2023,,Debit,-18.36,,61961324,AutoZone,Automotive Expenses,Debit Card,70.33,,POS Card purchase AUTOZONE 02502 5533 1425 S EL PASEO RD LAS CRUCES NM
,7/20/2023,,Debit,-8.75,,61954907,Aggie Car Wash,Automotive Expenses,Debit Card,88.69,,Debit Card purchase AGGIE CARWASH 7542 LAS CRUCES NM
,7/19/2023,,Credit,60,,61907179,ATM Deposit CU ANYTIME XX 1715 EAST UNIVERSITY LAS CRUCES NM,Deposits,,97.44,,ATM Deposit CU ANYTIME 6011 1715 EAST UNIVERSITY LAS CRUCES NM
,7/19/2023,,Debit,-8.35,,61907177,Walmart,Shopping,Debit Card,37.44,,POS Card purchase WM SUPERCENTER #806 5411 WAL-MART SUPER CENTER LAS CRUCES NM
,7/19/2023,,Debit,-0.65,,61907178,La Finca,Groceries,Debit Card,45.79,,Debit Card purchase LA FINCA MEAT MARKET 2 5422 LAS CRUCES NM
,7/19/2023,,Debit,-38.98,,61897943,Marathon Petroleum,Gasoline/Fuel,Debit Card,46.44,,Debit Card purchase MARATHON PETRO235069 5542 LEMITAR NM
,7/19/2023,,Debit,-20.78,,61897942,El Parasol,Restaurants & Dining,Debit Card,85.42,,Debit Card purchase EL PARASOL 5812 ESPANOLA NM
,7/18/2023,,Credit,98.25,,61839209,Debit Deposit VENMO*MALCOM ISAIAH 4829 NEW YORK CITY NY,Transfers,,106.2,,Debit Deposit VENMO*MALCOM ISAIAH 4829 NEW YORK CITY NY
,7/18/2023,,Debit,-21.6,,61838764,Adobe Creative Cloud,Online Services,,7.95,,Bill payment Withdrawal ADOBE *CREATIVE CLOUD 5734 408-536-6000 CA
,7/17/2023,,Debit,-11.99,,61773010,HOSTINGER* HOSTINGER.C 7372 KAUNAS LT,Online Services,Debit Card,29.55,,Debit Card purchase HOSTINGER* HOSTINGER.C 7372 KAUNAS LT
,7/17/2023,,Debit,-10.82,,61758159,Planet Fitness,Personal Care & Fitness,,41.54,,ACH Withdrawal COMPANY: PLANET FIT ENTRY: CLUB FEES 575-522-7867 ISAIAH MALCOM
,7/17/2023,,Debit,-3.29,,61758158,Speedway,Gasoline/Fuel,Debit Card,52.36,,Debit Card purchase SPEEDWAY 09128 1685 E. UN 5541 LAS CRUCES NM
,7/15/2023,,Debit,-10.59,,61650546,Starbucks,Restaurants & Dining,Debit Card,55.65,,Debit Card purchase STARBUCKS STORE 11645 5814 LAS CRUCES NM
,7/13/2023,,Debit,-500,,61527446,Withdrawal,ATM/Cash Withdrawals,Withdrawal,66.24,,Withdrawal
,7/13/2023,,Credit,500,,61527444,Deposit Transfer from James Matthew Malcom #######535 S0002,Transfers,Transfer,566.24,,Deposit Transfer from James Matthew Malcom #######535 S0002
,7/13/2023,,Debit,-5.32,,61527443,YouTube Music,Entertainment,Debit Card,66.24,,Debit Card purchase GOOGLE *YOUTUBE MUSIC 7829 G.CO/HELPPAY# CA
,7/13/2023,,Debit,-20.16,,61527445,Speedway,Gasoline/Fuel,Debit Card,71.56,,Debit Card purchase SPEEDWAY 09128 1685 E. UN 5542 LAS CRUCES NM
,7/12/2023,,Credit,80,,61477692,ATM Deposit CU ANYTIME 6011 1600S VALLEY DR LAS CRUCES NM,Deposits,,91.72,,ATM Deposit CU ANYTIME 6011 1600S VALLEY DR LAS CRUCES NM
,7/12/2023,,Credit,10,,61477691,ATM Deposit CU ANYTIME 6011 1600S VALLEY DR LAS CRUCES NM,Deposits,,11.72,,ATM Deposit CU ANYTIME 6011 1600S VALLEY DR LAS CRUCES NM
,7/9/2023,,Debit,-9,,61278162,Aggie Car Wash,Automotive Expenses,Debit Card,1.72,,Debit Card purchase AGGIE CARWASH 7542 LAS CRUCES NM
,7/8/2023,,Debit,-39.99,,61235494,Payment to Comcast,Cable & Satellite,,10.72,,Bill payment Withdrawal COMCAST CABLE COMM 4899 800-COMCAST CO
,7/8/2023,,Debit,-76.07,,61235493,Harbor Freight Tools,Home Supplies,Debit Card,50.71,,Debit Card purchase HARBOR FREIGHT TOOLS 236 5251 LAS CRUCES NM
,7/8/2023,,Debit,-141,,61209540,Dick's Sporting Goods,Shopping,Debit Card,126.78,,Debit Card purchase DICKS SPORTING GOODS 5941 LAS CRUCES NM
,7/7/2023,,Credit,49.13,,61191979,Debit Deposit VENMO*MALCOM ISAIAH 4829 NEW YORK CITY NY,Transfers,,267.78,,Debit Deposit VENMO*MALCOM ISAIAH 4829 NEW YORK CITY NY
,7/7/2023,,Debit,-5.99,,61184476,Walgreens,Healthcare & Pharmacy,Debit Card,218.65,,POS Card purchase WALGREENS STORE 1256 EL P 5912 LAS CRUCES NM
,7/6/2023,,Debit,-16.7,,61184477,Raising Cane's,Restaurants & Dining,Debit Card,224.64,,Debit Card purchase RAISING CANES 0340 5814 LAS CRUCES NM
,7/5/2023,,Credit,245,,61045505,ACH Deposit COMPANY: VENMO ENTRY: CASHOUT ISAIAH MALCOM,Transfers,ACH,241.34,,ACH Deposit COMPANY: VENMO ENTRY: CASHOUT ISAIAH MALCOM
,7/4/2023,,Debit,-16.7,,61045504,Raising Cane's,Restaurants & Dining,Debit Card,-3.66,,Debit Card purchase RAISING CANES 0340 5814 LAS CRUCES NM
,7/4/2023,,Debit,-100,,60984731,Instacopy,Printing,Debit Card,13.04,,Debit Card purchase INSTA COPY 5943 LAS CRUCES NM
,7/4/2023,,Debit,-46.05,,60983362,Kona Grill,Restaurants & Dining,Debit Card,113.04,,Debit Card purchase KONA GRILL - EL PASO 5812 EL PASO TX
,7/3/2023,,Debit,-5.84,,60983361,Menchie's Frozen Yogurt,Restaurants & Dining,Debit Card,159.09,,Debit Card purchase MENCHIES - MENB704 5814 EL PASO TX
,7/3/2023,,Debit,-26.23,,60948983,Supercuts,Personal Care & Fitness,Debit Card,164.93,,Debit Card purchase SUPERCUTS 7298 LAS CRUCES NM
,7/3/2023,,Credit,98.25,,60928315,Debit Deposit VENMO*MALCOM ISAIAH 4829 NEW YORK CITY NY,Transfers,,191.16,,Debit Deposit VENMO*MALCOM ISAIAH 4829 NEW YORK CITY NY
,7/3/2023,,Debit,-48.09,,60922414,Speedway,Gasoline/Fuel,Debit Card,92.91,,Debit Card purchase SPEEDWAY 09128 1685 E. UN 5542 LAS CRUCES NM
,7/2/2023,,Debit,-15.48,,60922413,Taqueria El Cometa,Restaurants & Dining,Debit Card,141,,Debit Card purchase TAQUERIA EL COMETA 5812 EL PASO TX
,7/2/2023,,Credit,54.04,,60892313,Debit Deposit VENMO*MALCOM ISAIAH 4829 NEW YORK CITY NY,Transfers,,156.48,,Debit Deposit VENMO*MALCOM ISAIAH 4829 NEW YORK CITY NY
,6/29/2023,,Debit,-11.62,,60750449,Wendy's,Restaurants & Dining,Debit Card,102.44,,POS Card purchase WENDY'S 8028 5814 565 WALTON BLVD LAS CRUCES NM
,6/29/2023,,Credit,95,,60726696,ATM Deposit CU ANYTIME XX 1715 EAST UNIVERSITY LAS CRUCES NM,Deposits,,114.06,,ATM Deposit CU ANYTIME 6011 1715 EAST UNIVERSITY LAS CRUCES NM
,6/29/2023,,Debit,-30.03,,60726695,Circle K,Groceries,Debit Card,19.06,,POS Card purchase CIRCLE K # 09665 5542 LAS CRUCES NM
,6/29/2023,,Debit,-3.49,,60691956,Circle K,Groceries,Debit Card,49.09,,Debit Card purchase CIRCLE K # 09672 5541 LAS CRUCES NM
,6/27/2023,,Debit,-25.82,,60691955,Planet Fitness,Personal Care & Fitness,,52.58,,Bill payment Withdrawal ABC*PLANET FITNESS 7997 575-5227867 NM
,6/27/2023,,Debit,-51.41,,60691954,HOSTINGER.COM 5734 LARNAKA CY,Online Services,Debit Card,78.4,,Debit Card purchase HOSTINGER.COM 5734 LARNAKA CY
,6/27/2023,,Debit,-10.17,,60691953,HOSTINGER.COM 5734 LARNAKA CY,Online Services,Debit Card,129.81,,Debit Card purchase HOSTINGER.COM 5734 LARNAKA CY
,6/26/2023,,Debit,-2.25,,60550385,Aggie Car Wash,Automotive Expenses,Debit Card,139.98,,Debit Card purchase AGGIE CARWASH 7542 LAS CRUCES NM
,6/25/2023,,Debit,-21.83,,60550384,AutoZone,Automotive Expenses,Debit Card,142.23,,POS Card purchase AUTOZONE 5677 5533 1203 EAST LOHMAN A LAS CRUCES NM
,6/25/2023,,Credit,200,,60482669,Online banking Deposit Transfer from S0000,Deposits,Transfer,164.06,,Online banking Deposit Transfer from S0000
,6/20/2023,,Debit,-30,,60482626,Planet Fitness Service Charges/Fees,Service Charges & Fees,Fees,-35.94,,Fee Withdrawal COMPANY: PLANET FIT ENTRY: CLUB FEES 575-522-7867 ISAIAH MALCOM - NSF Fee
,6/20/2023,,Debit,-8.11,,60482625,Starbucks,Restaurants & Dining,Debit Card,-5.94,,Debit Card purchase STARBUCKS STORE 02774 5814 LAS CRUCES NM
,6/20/2023,,Debit,-27.52,,60482624,Chevron,Gasoline/Fuel,Debit Card,2.17,,Debit Card purchase CHEVRON 0075976 5542 SOCORRO NM
,6/18/2023,,Debit,-5.38,,60099376,The Home Depot,Home Supplies,Debit Card,29.69,,POS Card purchase NST THE HOME DEPOT 000080 5200 225 TELSHORE BLVD LAS CRUCES NM
,6/18/2023,,Debit,-21.63,,60099377,Adobe Creative Cloud,Online Services,,35.07,,Bill payment Withdrawal ADOBE *CREATIVE CLOUD 5734 408-536-6000 CA
,6/17/2023,,Debit,-11.99,,60072966,HOSTINGER.COM 5734 LARNAKA CY,Online Services,Debit Card,56.7,,Debit Card purchase HOSTINGER.COM 5734 LARNAKA CY
,6/17/2023,,Debit,-5,,60072965,Aggie Car Wash,Automotive Expenses,Debit Card,68.69,,Debit Card purchase AGGIE CARWASH 7542 LAS CRUCES NM
,6/15/2023,,Debit,-154.69,,59950163,AutoZone,Automotive Expenses,Debit Card,73.69,,POS Card purchase AUTOZONE 02523 5533 2940 N MAIN ST LAS CRUCES NM
,6/15/2023,,Debit,-20,,59946076,Online banking Withdrawal Transfer to LXX00 - Credit Card,Credit Card Payments,Transfer,228.38,,Online banking Withdrawal Transfer to L0100 - Credit Card Payment
,6/15/2023,,Credit,196.5,,59946077,Debit Deposit VENMO*MALCOM ISAIAH 4829 NEW YORK CITY NY,Transfers,,248.38,,Debit Deposit VENMO*MALCOM ISAIAH 4829 NEW YORK CITY NY
,6/15/2023,,Credit,32.05,,59945141,Uber,Travel & Commute,,51.88,,POS Deposit UBER UBER 182 6051 SAN FRANCISCO CA
,6/14/2023,,Debit,-51.1,,59907542,Sprouts Farmers Market,Groceries,Debit Card,19.83,,Debit Card purchase SPROUTS FARMERS MAR 5411 LAS CRUCES NM
,6/14/2023,,Debit,-4.12,,59900038,Sam's Club,Shopping,Debit Card,70.93,,POS Card purchase SAMSCLUB #4784 5411 2711 NORTH TELSHORE BLV LAS CRUCES NM
,6/14/2023,,Debit,-30.75,,59894582,Sam's Club,Shopping,Debit Card,75.05,,POS Card purchase SAMSCLUB #4784 5542 2711 NORTH TELSHORE BLV LAS CRUCES NM
,6/14/2023,,Debit,-4.75,,59893779,Aggie Car Wash,Automotive Expenses,Debit Card,105.8,,Debit Card purchase AGGIE CARWASH 7542 LAS CRUCES NM
,6/14/2023,,Debit,-11.2,,59893778,McDonald's,Restaurants & Dining,Debit Card,110.55,,Debit Card purchase MCDONALD'S F20533 5814 LAS CRUCES NM
,6/13/2023,,Debit,-9.72,,59846155,Walmart,Shopping,Debit Card,121.75,,POS Card purchase WAL-MART #0806 5411 571 WALTON BLVD LAS CRUCES NM
,6/13/2023,,Credit,100.49,,59845683,Uber,Travel & Commute,,131.47,,POS Deposit UBER UBER 182 6051 SAN FRANCISCO CA
,6/13/2023,,Debit,-200,,59820899,Online banking Withdrawal Transfer to LXX00 - Credit Card,Credit Card Payments,Transfer,30.98,,Online banking Withdrawal Transfer to L0100 - Credit Card Payment
,6/13/2023,,Debit,-12,,59820839,Whataburger,Restaurants & Dining,Debit Card,230.98,,Debit Card purchase WHATABURGER 436 Q26 5814 EL PASO TX
,6/13/2023,,Debit,-9.2,,59820838,Starbucks,Restaurants & Dining,Debit Card,242.98,,Debit Card purchase STARBUCKS STORE 17330 5814 EL PASO TX
,6/13/2023,,Credit,250,,59820841,ACH Deposit COMPANY: VENMO ENTRY: CASHOUT ISAIAH MALCOM,Transfers,ACH,252.18,,ACH Deposit COMPANY: VENMO ENTRY: CASHOUT ISAIAH MALCOM
,6/13/2023,,Debit,-42.92,,59820840,Speedway,Gasoline/Fuel,Debit Card,2.18,,Debit Card purchase SPEEDWAY 09844 7900 ARTCR 5542 EL PASO TX
,6/13/2023,,Credit,0.09,,59820837,Deposit Transfer from SXX00 - Overdraft Transfer,Transfers,Transfer,45.1,,Deposit Transfer from S0000 - Overdraft Transfer
,6/13/2023,,Debit,-80,,59800782,Online banking Withdrawal Transfer to LXX00 - Credit Card,Credit Card Payments,Transfer,45.01,,Online banking Withdrawal Transfer to L0100 - Credit Card Payment
,6/13/2023,,Debit,-10.87,,59800778,Amazon,Shopping,Debit Card,125.01,,Debit Card purchase PRIME VIDEO CHANNELS 5818 AMZN.COM/BILL WA
,6/12/2023,,Credit,95.77,,59777673,Uber,Travel & Commute,,135.88,,POS Deposit UBER UBER 182 6051 SAN FRANCISCO CA
,6/11/2023,,Debit,-12.67,,59720848,Panda Express,Restaurants & Dining,Debit Card,40.11,,Debit Card purchase PANDA EXPRESS #2342 5814 EL PASO TX
,6/11/2023,,Debit,-1.5,,59720853,Brown Bag Deli,Restaurants & Dining,Debit Card,52.78,,Debit Card purchase BROWN BAG DELI 5812 ALAMOGORDO NM
,6/11/2023,,Debit,-7.11,,59720852,Brown Bag Deli,Restaurants & Dining,Debit Card,54.28,,Debit Card purchase BROWN BAG DELI 5812 ALAMOGORDO NM
,6/10/2023,,Debit,-44.72,,59720847,Shell,Gasoline/Fuel,Debit Card,61.39,,POS Card purchase SHELL SERVICE STATION 5542 ALAMOGORDO NM
,6/10/2023,,Debit,-3.25,,59720851,Aggie Car Wash,Automotive Expenses,Debit Card,106.11,,Debit Card purchase AGGIE CARWASH 7542 LAS CRUCES NM
,6/10/2023,,Debit,-18.14,,59720850,TST* ANGRY OWL 5812 EL PASO TX,Restaurants & Dining,Debit Card,109.36,,Debit Card purchase TST* ANGRY OWL 5812 EL PASO TX
,6/10/2023,,Debit,-10.66,,59720846,YouTube Music,Entertainment,Debit Card,127.5,,Debit Card purchase GOOGLE *YOUTUBE MUSIC 7829 G.CO/HELPPAY# CA
,6/10/2023,,Debit,-9.22,,59720849,Square,Online Services,Debit Card,138.16,,Debit Card purchase SQ *HABIT@T BOBA TEA 5499 CANUTILLO TX
,6/10/2023,,Debit,-4.87,,59662798,Burritos Victoria,Restaurants & Dining,Debit Card,147.38,,Debit Card purchase BURRITOS VICTORIA 5812 LAS CRUCES NM
,6/9/2023,,Credit,147.38,,59639089,Debit Deposit VENMO*MALCOM ISAIAH 4829 NEW YORK CITY NY,Transfers,,152.25,,Debit Deposit VENMO*MALCOM ISAIAH 4829 NEW YORK CITY NY
,6/9/2023,,Debit,-5.25,,59639088,Aggie Car Wash,Automotive Expenses,Debit Card,4.87,,Debit Card purchase AGGIE CARWASH 7542 LAS CRUCES NM
,6/9/2023,,Credit,0.79,,59639087,Deposit Transfer from SXX00 - Overdraft Transfer,Transfers,Transfer,10.12,,Deposit Transfer from S0000 - Overdraft Transfer
,6/9/2023,,Debit,-39.99,,59627026,Payment to Comcast,Cable & Satellite,,9.33,,Bill payment Withdrawal COMCAST CABLE COMM 4899 800-COMCAST CO
,6/9/2023,,Debit,-2.6,,59627025,CROSSROADS PRINTING 2741 EL PASO TX,Printing,Debit Card,49.32,,Debit Card purchase CROSSROADS PRINTING 2741 EL PASO TX
,6/8/2023,,Debit,-11.14,,59627024,Wendy's,Restaurants & Dining,Debit Card,51.92,,POS Card purchase WENDY'S 3728 5814 7453 N MESA ST EL PASO TX
,6/8/2023,,Debit,-8.44,,59588268,Starbucks,Restaurants & Dining,Debit Card,63.06,,Debit Card purchase STARBUCKS STORE 02774 5814 LAS CRUCES NM
,6/7/2023,,Debit,-32.1,,59554289,Spotted Dog Brewery,Restaurants & Dining,Debit Card,71.5,,Debit Card purchase SPOTTED DOG BREWERY 5812 LAS CRUCES NM
,6/7/2023,,Debit,-1,,59525527,ARCADE GAME 5814 EDMOND OK,Entertainment,Debit Card,103.6,,Debit Card purchase ARCADE GAME 5814 EDMOND OK
,6/7/2023,,Debit,-1,,59525526,ARCADE GAME 5814 EDMOND OK,Entertainment,Debit Card,104.6,,Debit Card purchase ARCADE GAME 5814 EDMOND OK
,6/6/2023,,Credit,100,,59494717,Deposit,Deposits,Deposit,105.6,,Deposit
,6/6/2023,,Debit,-13,,59465345,Chevron,Gasoline/Fuel,Debit Card,5.6,,Debit Card purchase CHEVRON 0204989 5542 LAS CRUCES NM
,6/5/2023,,Debit,-16.01,,59422388,Raising Cane's,Restaurants & Dining,Debit Card,18.6,,Debit Card purchase RAISING CANES 0340 5814 LAS CRUCES NM
,6/4/2023,,Credit,24.3,,59354213,Uber,Travel & Commute,,34.61,,POS Deposit UBER UBER 182 6051 SAN FRANCISCO CA
,6/4/2023,,Debit,-10.61,,59347365,McDonald's,Restaurants & Dining,Debit Card,10.31,,Debit Card purchase MCDONALD'S F20533 5814 LAS CRUCES NM
,6/2/2023,,Debit,-25.82,,59308561,Planet Fitness,Personal Care & Fitness,,20.92,,Bill payment Withdrawal ABC*PLANET FITNESS 7997 575-5227867 NM
,6/2/2023,,Debit,-7.42,,59308560,McDonald's,Restaurants & Dining,Debit Card,46.74,,POS Card purchase MCDONALD'S F20533 5814 1751 E UNIVERSITY AVE LAS CRUCES NM
,6/2/2023,,Debit,-16.72,,59261722,Raising Cane's,Restaurants & Dining,Debit Card,54.16,,Debit Card purchase RAISING CANES 0340 5814 LAS CRUCES NM
,6/1/2023,,Debit,-32.49,,59261721,Salud! De Mesilla,Restaurants & Dining,Debit Card,70.88,,Debit Card purchase TST* SALUD DE MESILLA 5812 LAS CRUCES NM
,5/31/2023,,Debit,-30.17,,59111013,Circle K,Groceries,Debit Card,103.37,,POS Card purchase CIRCLE K # 41289 5542 LAS CRUCES NM
,5/30/2023,,Debit,-4.48,,59101297,Shortys,Restaurants & Dining,Debit Card,133.54,,Debit Card purchase SHORTYS IN MESILLA 5541 LAS CRUCES NM
,5/30/2023,,Debit,-11.67,,59101296,Wendy's,Restaurants & Dining,Debit Card,138.02,,POS Card purchase WENDY'S 8028 5814 565 WALTON BLVD LAS CRUCES NM
,5/30/2023,,Credit,98.25,,59021338,Debit Deposit VENMO*MALCOM ISAIAH 4829 NEW YORK CITY NY,Transfers,,149.69,,Debit Deposit VENMO*MALCOM ISAIAH 4829 NEW YORK CITY NY
,5/30/2023,,Debit,-10.6,,59018148,Starbucks,Restaurants & Dining,Debit Card,51.44,,Debit Card purchase STARBUCKS STORE 02774 5814 LAS CRUCES NM
,5/30/2023,,Debit,-19.47,,59018150,MCW#x386-LUJAN 7542 LAS CRUCES NM,Restaurants & Dining,Debit Card,62.04,,Debit Card purchase MCW#0386-LUJAN 7542 LAS CRUCES NM
,5/30/2023,,Debit,-15.23,,59018149,Circle K,Groceries,Debit Card,81.51,,Debit Card purchase CIRCLE K # 09681 5542 LAS CRUCES NM
,5/29/2023,,Debit,-13.08,,58976327,Whataburger,Restaurants & Dining,Debit Card,96.74,,Debit Card purchase WHATABURGER 421 Q26 5814 MESA AZ
,5/29/2023,,Debit,-6.44,,58976326,Starbucks,Restaurants & Dining,Debit Card,109.82,,Debit Card purchase STARBUCKS STORE 23472 5814 MESA AZ
,5/29/2023,,Debit,-4.09,,58976325,Chevron,Gasoline/Fuel,Debit Card,116.26,,Debit Card purchase CHEVRON 0352231 5541 APACHE JUNCTI AZ
,5/29/2023,,Debit,-41.03,,58976324,Chevron,Gasoline/Fuel,Debit Card,120.35,,Debit Card purchase CHEVRON 0352231 5542 APACHE JUNCTI AZ
,5/28/2023,,Debit,-23.64,,58976323,IHOP,Restaurants & Dining,Debit Card,161.38,,Debit Card purchase IHOP 1508 5812 PHOENIX AZ
,5/27/2023,,Debit,-4.69,,58927898,BUTTERFIELD STATION TRAVE 5499 DEMING NM,Gasoline/Fuel,Debit Card,185.02,,Debit Card purchase BUTTERFIELD STATION TRAVE 5499 DEMING NM
,5/27/2023,,Debit,-17.78,,58927897,Whataburger,Restaurants & Dining,Debit Card,189.71,,Debit Card purchase WHATABURGER 785 5814 LAS CRUCES NM
,5/27/2023,,Debit,-7.13,,58927896,Starbucks,Restaurants & Dining,Debit Card,207.49,,Debit Card purchase STARBUCKS STORE 53805 5814 TEMPE AZ
,5/27/2023,,Debit,-96.19,,58880701,Jiffy Lube,Automotive Expenses,Debit Card,214.62,,Debit Card purchase JIFFY LUBE #2944 7538 LAS CRUCES NM
,5/27/2023,,Debit,-5,,58880700,Walgreens,Healthcare & Pharmacy,Debit Card,310.81,,POS Card purchase WALGREENS STORE 204 E BEL 5912 PHOENIX AZ
,5/26/2023,,Debit,-31.68,,58872484,Marathon Petroleum,Gasoline/Fuel,Debit Card,315.81,,POS Card purchase MARATHON P 5542 3890 GAGE STATION US DEMING NM
,5/26/2023,,Debit,-48.8,,58872483,Supercuts,Personal Care & Fitness,Debit Card,347.49,,Debit Card purchase SUPERCUTS 7298 LAS CRUCES NM
,5/26/2023,,Credit,343.88,,58843949,Debit Deposit VENMO*MALCOM ISAIAH 4829 NEW YORK CITY NY,Transfers,,396.29,,Debit Deposit VENMO*MALCOM ISAIAH 4829 NEW YORK CITY NY
,5/26/2023,,Credit,49.13,,58830880,Debit Deposit VENMO*MALCOM ISAIAH 4829 NEW YORK CITY NY,Transfers,,52.41,,Debit Deposit VENMO*MALCOM ISAIAH 4829 NEW YORK CITY NY
,5/22/2023,,Debit,-12.32,,58661753,Whataburger,Restaurants & Dining,Debit Card,3.28,,Debit Card purchase WHATABURGER 465 5814 LAS CRUCES NM
,5/22/2023,,Debit,-16.31,,58661752,Amazon,Shopping,,15.6,,Bill payment Withdrawal AMAZON PRIME*S773B8SU3 5968 AMZN.COM/BILL WA
,5/21/2023,,Debit,-4.1,,58591471,Corner Bakery Cafe,Restaurants & Dining,Debit Card,31.91,,Debit Card purchase CORNER BAKERY CAFE 1565 5812 LAS CRUCES NM
,5/18/2023,,Debit,-11.99,,58550040,HOSTINGER.COM 5734 LARNAKA CY,Online Services,Debit Card,36.01,,Debit Card purchase HOSTINGER.COM 5734 LARNAKA CY
,5/18/2023,,Credit,48,,58465973,Online banking Deposit Transfer from S0000,Transfers,Transfer,48,,Online banking Deposit Transfer from S0000
,5/18/2023,,Debit,-21.63,,58465931,Adobe,Online Services,,0,,"Bill payment Withdrawal ADOBE 5817 PARK AVENUE,345 SAN JOSE CA"
,5/18/2023,,Credit,51.12,,58465929,Deposit Transfer from SXX00 - Overdraft Transfer,Transfers,Transfer,21.63,,Deposit Transfer from S0000 - Overdraft Transfer
,5/17/2023,,Debit,-30,,58391904,Planet Fitness Service Charges/Fees,Service Charges & Fees,Fees,-29.49,,Fee Withdrawal COMPANY: PLANET FIT ENTRY: CLUB FEES 575-522-7867 ISAIAH MALCOM - NSF Fee
,5/14/2023,,Debit,-15.11,,58391903,Speedway,Gasoline/Fuel,Debit Card,0.51,,POS Card purchase SPEEDWAY 5542 1685 E UNIVERSITY AVE LAS CRUCES NM
,5/14/2023,,Debit,-12.53,,58222514,Blake's Lotaburger,Restaurants & Dining,Debit Card,15.62,,Debit Card purchase BLAKE S LOTABURGER - 028 5814 LAS CRUCES NM
,5/13/2023,,Debit,-5.18,,58161789,Corner Bakery Cafe,Restaurants & Dining,Debit Card,28.15,,Debit Card purchase CORNER BAKERY CAFE 1565 5812 LAS CRUCES NM
,5/13/2023,,Debit,-10.87,,58161790,PRIME VIDEO*G61ZG5TI3 XX-3080 WA,Entertainment,Debit Card,33.33,,Debit Card purchase PRIME VIDEO*G61ZG5TI3 5818 888-802-3080 WA
,5/12/2023,,Debit,-8.44,,58131789,Starbucks,Restaurants & Dining,Debit Card,44.2,,Debit Card purchase STARBUCKS STORE 10747 5814 LAS CRUCES NM
,5/12/2023,,Debit,-3.77,,58100507,Corner Bakery Cafe,Restaurants & Dining,Debit Card,52.64,,Debit Card purchase CORNER BAKERY CAFE 1565 5812 LAS CRUCES NM
,5/11/2023,,Debit,-8.75,,58078316,Jack in the Box,Restaurants & Dining,Debit Card,56.41,,Debit Card purchase JACK IN THE BOX 1258 5814 LAS CRUCES NM
,5/11/2023,,Debit,-36.03,,58062941,Lowe's,Home Supplies,Debit Card,65.16,,POS Card purchase LOWE'S #1158 5200 LAS CRUCES NM
,5/11/2023,,Debit,-29.71,,58062940,The Home Depot,Home Supplies,Debit Card,101.19,,POS Card purchase NST THE HOME DEPOT 000165 5200 225 TELSHORE BLVD LAS CRUCES NM
,5/10/2023,,Debit,-17.4,,58048150,Whataburger,Restaurants & Dining,Debit Card,130.9,,Debit Card purchase WHATABURGER 785 5814 LAS CRUCES NM
,5/10/2023,,Debit,-10.66,,58048149,YouTube Music,Entertainment,Debit Card,148.3,,Debit Card purchase GOOGLE *YOUTUBE MUSIC 7829 G.CO/HELPPAY# CA
,5/9/2023,,Debit,-39.99,,57984210,Payment to Comcast,Cable & Satellite,,158.96,,Bill payment Withdrawal COMCAST CABLE COMM 4899 800-COMCAST CO
,5/7/2023,,Credit,196.5,,57943456,Debit Deposit VENMO*MALCOM ISAIAH 4829 NEW YORK CITY NY,Transfers,,198.95,,Debit Deposit VENMO*MALCOM ISAIAH 4829 NEW YORK CITY NY
,4/30/2023,,Debit,-10.38,,57449343,Starbucks,Restaurants & Dining,Debit Card,2.45,,Debit Card purchase STARBUCKS STORE 11645 5814 LAS CRUCES NM
,4/28/2023,,Debit,-16.01,,57386381,Raising Cane's,Restaurants & Dining,Debit Card,12.83,,Debit Card purchase RAISING CANES 0340 5814 LAS CRUCES NM
,4/26/2023,,Debit,-16.01,,57258188,Raising Cane's,Restaurants & Dining,Debit Card,28.84,,Debit Card purchase RAISING CANES 0340 5814 LAS CRUCES NM
,4/25/2023,,Debit,-60,,57198405,Online banking Withdrawal Transfer to LXX00 - Credit Card,Credit Card Payments,Transfer,44.85,,Online banking Withdrawal Transfer to L0100 - Credit Card Payment
,4/25/2023,,Debit,-12.86,,57198351,Whataburger,Restaurants & Dining,Debit Card,104.85,,Debit Card purchase WHATABURGER 465 5814 LAS CRUCES NM
,4/25/2023,,Debit,-32.01,,57198350,GOOGLE *PLAY CONSOLE 5818 G.CO/HELPPAY# CA,Online Services,Debit Card,117.71,,Debit Card purchase GOOGLE *PLAY CONSOLE 5818 G.CO/HELPPAY# CA
,4/24/2023,,Credit,147.38,,57111039,Debit Deposit VENMO*MALCOM ISAIAH 4829 NEW YORK CITY NY,Transfers,,149.72,,Debit Deposit VENMO*MALCOM ISAIAH 4829 NEW YORK CITY NY
,4/22/2023,,Debit,-9.87,,57081363,Speedway,Gasoline/Fuel,Debit Card,2.34,,POS Card purchase SPEEDWAY 5541 1685 E UNIVERSITY AVE LAS CRUCES NM
,4/22/2023,,Debit,-8.22,,57041840,Starbucks,Restaurants & Dining,Debit Card,12.21,,Debit Card purchase STARBUCKS STORE 11645 5814 LAS CRUCES NM
,4/21/2023,,Debit,-19.47,,57041841,MCW#x386-LUJAN 7542 LAS CRUCES NM,Restaurants & Dining,Debit Card,20.43,,Debit Card purchase MCW#0386-LUJAN 7542 LAS CRUCES NM
,4/21/2023,,Debit,-11.97,,57012335,Sprouts Farmers Market,Groceries,Debit Card,39.9,,Debit Card purchase SPROUTS FARMERS MAR 5411 LAS CRUCES NM
,4/21/2023,,Debit,-32.45,,57012336,Udemy,Education,Debit Card,51.87,,Debit Card purchase UDEMY: ONLINE COURSES 8299 HTTPSWWW.UDEM CA
,4/21/2023,,Debit,-24.1,,56988999,Starbucks,Restaurants & Dining,Debit Card,84.32,,Debit Card purchase STARBUCKS STORE 10747 5814 LAS CRUCES NM
,4/21/2023,,Debit,-21.63,,56988998,AutoZone,Automotive Expenses,Debit Card,108.42,,Debit Card purchase AUTOZONE 05677 5533 LAS CRUCES NM
,4/20/2023,,Debit,-20.72,,56950321,Raising Cane's,Restaurants & Dining,Debit Card,130.05,,Debit Card purchase RAISING CANES 0340 5814 LAS CRUCES NM
,4/18/2023,,Debit,-16.72,,56839832,Raising Cane's,Restaurants & Dining,Debit Card,150.77,,Debit Card purchase RAISING CANES 0340 5814 LAS CRUCES NM
,4/17/2023,,Debit,-16.98,,56839831,HOSTINGER* HOSTINGER.C 7372 KAUNAS LT,Online Services,Debit Card,167.49,,Debit Card purchase HOSTINGER* HOSTINGER.C 7372 KAUNAS LT
,4/17/2023,,Debit,-1.17,,56839830,HOSTINGER.COM 5734 LARNAKA CY,Online Services,Debit Card,184.47,,Debit Card purchase HOSTINGER.COM 5734 LARNAKA CY
,4/17/2023,,Debit,-10.82,,56839829,Planet Fitness,Personal Care & Fitness,,185.64,,ACH Withdrawal COMPANY: PLANET FIT ENTRY: CLUB FEES 575-522-7867 ISAIAH MALCOM
,4/16/2023,,Credit,196.5,,56708511,Debit Deposit VENMO*MALCOM ISAIAH 4829 NEW YORK CITY NY,Transfers,,196.46,,Debit Deposit VENMO*MALCOM ISAIAH 4829 NEW YORK CITY NY
,4/13/2023,,Debit,-8.69,,56533231,PRIME VIDEO*HJ3DB5A52 XX-3080 WA,Entertainment,Debit Card,-0.04,,Debit Card purchase PRIME VIDEO*HJ3DB5A52 5818 888-802-3080 WA
,4/13/2023,,Debit,-2.89,,56533230,Circle K,Groceries,Debit Card,8.65,,Debit Card purchase CIRCLE K # 09672 5541 LAS CRUCES NM
,4/12/2023,,Debit,-17.64,,56533229,Los Mariachis Restaurant,Restaurants & Dining,Debit Card,11.54,,Debit Card purchase LOS MARIACHIS RESTAURANT 5812 LAS CRUCES NM
,4/12/2023,,Debit,-25.87,,56494646,CCSU FOOD CT 5814 LAS CRUCES NM,Groceries,Debit Card,29.18,,Debit Card purchase CCSU FOOD CT 5814 LAS CRUCES NM
,4/12/2023,,Debit,-19.99,,56494645,Payment to Comcast,Cable & Satellite,,55.05,,Bill payment Withdrawal COMCAST CABLE COMM 4899 800-COMCAST CO
,4/11/2023,,Debit,-10.6,,56442688,Panda Express,Restaurants & Dining,Debit Card,75.04,,Debit Card purchase PANDA EXPRESS #2206 5814 LAS CRUCES NM
,4/10/2023,,Debit,-15.49,,56442689,Netflix,Entertainment,,85.64,,Bill payment Withdrawal NETFLIX COM 4899 LOS GATOS CA
,4/10/2023,,Credit,100,,56380919,Online banking Deposit Transfer from S0000,Transfers,Transfer,101.13,,Online banking Deposit Transfer from S0000
,4/10/2023,,Debit,-10.66,,56366457,YouTube Music,Entertainment,Debit Card,1.13,,Debit Card purchase GOOGLE *YOUTUBE MUSIC 7829 G.CO/HELPPAY# CA
,4/5/2023,,Debit,-16.11,,56263116,AMZN MKTP US*HS7QB5DO0 5942 AMZN.COM/BILL WA,Shopping,Debit Card,11.79,,Debit Card purchase AMZN MKTP US*HS7QB5DO0 5942 AMZN.COM/BILL WA
,4/4/2023,,Debit,-49.88,,56085360,Amazon,Shopping,Debit Card,27.9,,POS Card purchase AMAZON.COM*HS4FN9TN1 4816 SEATTLE WA
,4/4/2023,,Debit,-12.01,,56069824,Raising Cane's,Restaurants & Dining,Debit Card,77.78,,Debit Card purchase RAISING CANES 0340 5814 LAS CRUCES NM
,4/3/2023,,Debit,-16.72,,56007072,Raising Cane's,Restaurants & Dining,Debit Card,89.79,,Debit Card purchase RAISING CANES 0299 5814 EL PASO TX
,4/3/2023,,Debit,-5.9,,56007069,Starbucks,Restaurants & Dining,Debit Card,106.51,,Debit Card purchase STARBUCKS STORE 61620 5814 EL PASO TX
,4/2/2023,,Debit,-8.19,,56007068,Walmart,Shopping,Debit Card,112.41,,POS Card purchase WAL-MART SUPER CENTER 5411 2201 WAL-SAMS EL PASO TX
,4/2/2023,,Debit,-35.38,,56007071,Speedway,Gasoline/Fuel,Debit Card,120.6,,POS Card purchase SPEEDWAY 5542 7301 NORTH LOOP EL PASO TX
,4/2/2023,,Credit,147.38,,56007070,Debit Deposit VENMO*MALCOM ISAIAH 4829 NEW YORK CITY NY,Transfers,,155.98,,Debit Deposit VENMO*MALCOM ISAIAH 4829 NEW YORK CITY NY
,4/1/2023,,Debit,-10.38,,55901173,Starbucks,Restaurants & Dining,Debit Card,8.6,,Debit Card purchase STARBUCKS STORE 11645 5814 LAS CRUCES NM
,4/1/2023,,Debit,-17.18,,55901172,Whataburger,Restaurants & Dining,Debit Card,18.98,,Debit Card purchase WHATABURGER 465 5814 LAS CRUCES NM
,3/30/2023,,Debit,-16.72,,55772659,Raising Cane's,Restaurants & Dining,Debit Card,36.16,,Debit Card purchase RAISING CANE'S #340 5814 LAS CRUCES NM
,3/29/2023,,Debit,-50,,55707280,Online banking Withdrawal Transfer to LXX00 - Credit Card,Credit Card Payments,Transfer,52.88,,Online banking Withdrawal Transfer to L0100 - Credit Card Payment
,3/28/2023,,Debit,-4.79,,55647334,Starbucks,Restaurants & Dining,Debit Card,102.88,,Debit Card purchase STARBUCKS STORE 11645 5814 LAS CRUCES NM
,3/27/2023,,Debit,-18.05,,55647335,Wendy's,Restaurants & Dining,Debit Card,107.67,,POS Card purchase WENDY'S 8028 5814 565 WALTON BLVD LAS CRUCES NM
,3/27/2023,,Debit,-12.65,,55582855,Whataburger,Restaurants & Dining,Debit Card,125.72,,Debit Card purchase WHATABURGER 785 5814 LAS CRUCES NM
,3/26/2023,,Debit,-14.6,,55547311,Blake's Lotaburger,Restaurants & Dining,Debit Card,138.37,,Debit Card purchase BLAKE S LOTABURGER - 028 5814 LAS CRUCES NM
,3/26/2023,,Debit,-28.53,,55547310,Dave & Buster's,Restaurants & Dining,Debit Card,152.97,,Debit Card purchase DAVE & BUSTER'S #92 5812 EL PASO TX
,3/25/2023,,Debit,-31.23,,55547308,Supercuts,Personal Care & Fitness,Debit Card,181.5,,Debit Card purchase SUPERCUTS 7298 LAS CRUCES NM
,3/25/2023,,Credit,196.5,,55547309,Debit Deposit VENMO*MALCOM ISAIAH 4829 NEW YORK CITY NY,Transfers,,212.73,,Debit Deposit VENMO*MALCOM ISAIAH 4829 NEW YORK CITY NY
,3/22/2023,,Debit,-16.31,,55365434,Amazon,Shopping,,16.23,,Bill payment Withdrawal AMAZON PRIME*H73G424E1 5968 AMZN.COM/BILL WA
,3/21/2023,,Credit,23,,55365435,ATM Deposit CU ANYTIME XX 1715 EAST UNIVERSITY LAS CRUCES NM,Deposits,,32.54,,ATM Deposit CU ANYTIME 6011 1715 EAST UNIVERSITY LAS CRUCES NM
,3/19/2023,,Debit,-7.44,,55312668,Caliche's Frozen Custard,Restaurants & Dining,Debit Card,9.54,,Debit Card purchase CALICHES FROZEN CUSTARD - 5812 LAS CRUCES NM
,3/19/2023,,Debit,-17.29,,55312667,Corner Bakery Cafe,Restaurants & Dining,Debit Card,16.98,,Debit Card purchase CORNER BAKERY CAFE 1565 5812 LAS CRUCES NM
,3/18/2023,,Debit,-14.02,,55162438,Lowe's,Home Supplies,Debit Card,34.27,,Debit Card purchase LOWES #01158* 5200 LAS CRUCES NM
,3/18/2023,,Debit,-63.14,,55162437,Amazon,Shopping,Debit Card,48.29,,POS Card purchase AMAZON.COM*HC7XE2UU0 4816 SEATTLE WA
,3/17/2023,,Debit,-13.29,,55162436,Wendy's,Restaurants & Dining,Debit Card,111.43,,POS Card purchase WENDY'S 8028 5814 565 WALTON BLVD LAS CRUCES NM
,3/17/2023,,Debit,-10.82,,55162435,Planet Fitness,Personal Care & Fitness,,124.72,,ACH Withdrawal COMPANY: PLANET FIT ENTRY: CLUB FEES 575-522-7867 ISAIAH MALCOM
,3/17/2023,,Debit,-30.21,,55162434,Speedway,Gasoline/Fuel,Debit Card,135.54,,Debit Card purchase SPEEDWAY 09128 1685 E. UN 5542 LAS CRUCES NM
,3/16/2023,,Credit,150,,55042592,Cash Deposit,Deposits,Deposit,165.75,,Cash Deposit
,3/13/2023,,Debit,-6.58,,54901411,Speedway,Gasoline/Fuel,Debit Card,15.75,,Debit Card purchase SPEEDWAY 09128 1685 E. UN 5541 LAS CRUCES NM
,3/13/2023,,Debit,-6.52,,54901409,Amazon Digital Services,Entertainment,Debit Card,22.33,,Debit Card purchase AMAZON DIGIT*HG3E22XU1 5818 888-802-3080 WA
,3/13/2023,,Debit,-10.87,,54901410,PRIME VIDEO*HG6NL7A22 XX-3080 WA,Entertainment,Debit Card,28.85,,Debit Card purchase PRIME VIDEO*HG6NL7A22 5818 888-802-3080 WA
,3/12/2023,,Debit,-55.77,,54836158,Walmart,Shopping,Debit Card,39.72,,POS Card purchase WM SUPERCENTER #806 5411 WAL-MART SUPER CENTER LAS CRUCES NM
,3/12/2023,,Debit,-12.5,,54836157,McDonald's,Restaurants & Dining,Debit Card,95.49,,Debit Card purchase MCDONALD'S F20533 5814 LAS CRUCES NM
,3/12/2023,,Debit,-35,,54836160,PARKING & ID SERVICES XX4835 NM,Travel & Commute,Debit Card,107.99,,Debit Card purchase PARKING & ID SERVICES 8220 5756464835 NM
,3/11/2023,,Debit,-50.33,,54836159,TST* BOSQUE BREWING COMPA 5813 LAS CRUCES NM,Restaurants & Dining,Debit Card,142.99,,Debit Card purchase TST* BOSQUE BREWING COMPA 5813 LAS CRUCES NM
,3/11/2023,,Debit,-11.26,,54797291,McDonald's,Restaurants & Dining,Debit Card,193.32,,Debit Card purchase MCDONALD'S F20533 5814 LAS CRUCES NM
,3/10/2023,,Debit,-10.66,,54775090,YouTube Music,Entertainment,Debit Card,204.58,,Debit Card purchase GOOGLE *YOUTUBE MUSIC 7829 G.CO/HELPPAY# CA
,3/10/2023,,Debit,-22.56,,54775091,CCSU FOOD CT 5814 LAS CRUCES NM,Groceries,Debit Card,215.24,,Debit Card purchase CCSU FOOD CT 5814 LAS CRUCES NM
,3/9/2023,,Debit,-2.34,,54680147,CCSU FOOD CT 5814 LAS CRUCES NM,Groceries,Debit Card,237.8,,Debit Card purchase CCSU FOOD CT 5814 LAS CRUCES NM
,3/8/2023,,Credit,200,,54651533,Cash Deposit,Deposits,Deposit,240.14,,Cash Deposit
,3/8/2023,,Credit,40.14,,54618984,Online banking Deposit Transfer from S0000,Transfers,Transfer,40.14,,Online banking Deposit Transfer from S0000
,3/6/2023,,Debit,-15.49,,54556360,Netflix,Entertainment,,0,,Bill payment Withdrawal NETFLIX COM 4899 LOS GATOS CA
,3/6/2023,,Credit,9.86,,54556356,Deposit Transfer from SXX00 - Overdraft Transfer,Transfers,Transfer,15.49,,Deposit Transfer from S0000 - Overdraft Transfer
,3/6/2023,,Debit,-19.99,,54556359,Payment to Comcast,Cable & Satellite,,5.63,,Bill payment Withdrawal COMCAST CABLE COMM 4899 800-COMCAST CO
,3/5/2023,,Debit,-21.19,,54556358,Urban Cafe,Restaurants & Dining,Debit Card,25.62,,Debit Card purchase URBAN CAFE 5812 LAS CRUCES NM
,3/5/2023,,Debit,-21.47,,54556357,MCW#x386-LUJAN 7542 LAS CRUCES NM,Restaurants & Dining,Debit Card,46.81,,Debit Card purchase MCW#0386-LUJAN 7542 LAS CRUCES NM
,3/2/2023,,Credit,50,,54323480,Online banking Deposit Transfer from S0000,Transfers,Transfer,68.28,,Online banking Deposit Transfer from S0000
,2/28/2023,,Debit,-13.63,,54218022,Amazon,Shopping,Debit Card,18.28,,POS Card purchase AMAZON.COM*HD2AD8VK2 5942 SEATTLE WA
,2/28/2023,,Debit,-37.84,,54218020,Target,Shopping,Debit Card,31.91,,Debit Card purchase TARGET 00007690 5310 LAS CRUCES NM
,2/27/2023,,Debit,-11.67,,54218021,Wendy's,Restaurants & Dining,Debit Card,69.75,,POS Card purchase WENDY'S 8028 5814 565 WALTON BLVD LAS CRUCES NM
,2/26/2023,,Debit,-20.2,,54114230,SQ *LOS CORRALES MEXICAN 5814 LAS CRUCES NM,Restaurants & Dining,Debit Card,81.42,,Debit Card purchase SQ *LOS CORRALES MEXICAN 5814 LAS CRUCES NM
,2/26/2023,,Debit,-26.88,,54114229,Dion's,Restaurants & Dining,Debit Card,101.62,,Debit Card purchase DIONS 12 5814 LAS CRUCES NM
,2/25/2023,,Debit,-20.19,,54017312,Taco Bell,Restaurants & Dining,Debit Card,128.5,,Debit Card purchase TACO BELL 001600167551 5814 LAS CRUCES NM
,2/25/2023,,Debit,-16.31,,54017311,Amazon,Shopping,,148.69,,Bill payment Withdrawal AMAZON PRIME*HP03F82X2 5968 AMZN.COM/BILL WA
,2/25/2023,,Debit,-22.71,,54017313,Amazon,Shopping,Debit Card,165,,POS Card purchase AMAZON.COM*HP4GZ8I31 4816 SEATTLE WA
,2/25/2023,,Debit,-12.65,,54017310,Whataburger,Restaurants & Dining,Debit Card,187.71,,Debit Card purchase WHATABURGER 581 5814 LAS CRUCES NM
,2/23/2023,,Credit,196.5,,53923901,Debit Deposit VENMO*MALCOM ISAIAH 4829 NEW YORK CITY NY,Transfers,,200.36,,Debit Deposit VENMO*MALCOM ISAIAH 4829 NEW YORK CITY NY
,2/17/2023,,Debit,-5.98,,53687908,Sprouts Farmers Market,Groceries,Debit Card,3.86,,Debit Card purchase SPROUTS FARMERS MAR 5411 LAS CRUCES NM
,2/17/2023,,Debit,-10.82,,53687909,Planet Fitness,Personal Care & Fitness,,9.84,,ACH Withdrawal COMPANY: PLANET FIT ENTRY: CLUB FEES 575-522-7867 ISAIAH MALCOM
,2/13/2023,,Debit,-164.88,,53443760,Kelly Liquors,Groceries,Debit Card,20.66,,Debit Card purchase KELLY LIQUORS 5921 LAS CRUCES NM
,2/13/2023,,Debit,-6.52,,53403804,Amazon Digital Services,Entertainment,Debit Card,185.54,,Debit Card purchase AMAZON DIGIT*HE7OB6OX1 5818 888-802-3080 WA
,2/13/2023,,Debit,-10.87,,53403805,PRIME VIDEO*HE57I1Q90 XX-3080 WA,Entertainment,Debit Card,192.06,,Debit Card purchase PRIME VIDEO*HE57I1Q90 5818 888-802-3080 WA
,2/13/2023,,Debit,-41.23,,53403803,Target,Shopping,Debit Card,202.93,,Debit Card purchase TARGET 00007690 5310 LAS CRUCES NM
,2/12/2023,,Debit,-13.34,,53359762,Walmart,Shopping,Debit Card,244.16,,POS Card purchase WM SUPERCENTER #806 5411 WAL-MART SUPER CENTER LAS CRUCES NM
,2/12/2023,,Debit,-6.66,,53359765,TST* ICEBOX BREWING COMPA 5813 LAS CRUCES NM,Restaurants & Dining,Debit Card,257.5,,Debit Card purchase TST* ICEBOX BREWING COMPA 5813 LAS CRUCES NM
,2/12/2023,,Debit,-2,,53359764,CSC SERVICEWORK 5814 LAS CRUCES NM,Online Services,Debit Card,264.16,,Debit Card purchase CSC SERVICEWORK 5814 LAS CRUCES NM
,2/11/2023,,Credit,245.63,,53359763,Debit Deposit VENMO*MALCOM ISAIAH 4829 NEW YORK CITY NY,Transfers,,266.16,,Debit Deposit VENMO*MALCOM ISAIAH 4829 NEW YORK CITY NY
,2/11/2023,,Debit,-56.42,,53307693,The Home Depot,Home Supplies,Debit Card,20.53,,POS Card purchase THE HOME DEPOT #3505 5200 225 TELSHORE BLVD LAS CRUCES NM
,2/10/2023,,Debit,-10.66,,53276018,YouTube Music,Entertainment,Debit Card,76.95,,Debit Card purchase GOOGLE *YOUTUBE MUSIC 7829 G.CO/HELPPAY# CA
,2/8/2023,,Debit,-28.84,,53193784,Circle K,Groceries,Debit Card,87.61,,POS Card purchase CIRCLE K # 41289 5542 LAS CRUCES NM
,2/6/2023,,Debit,-30,,53078149,Online banking Withdrawal Transfer to LXX00 - Credit Card,Credit Card Payments,Transfer,116.45,,Online banking Withdrawal Transfer to L0100 - Credit Card Payment
,2/6/2023,,Debit,-15.49,,53078121,Netflix,Entertainment,,146.45,,Bill payment Withdrawal NETFLIX.COM 4899 NETFLIX.COM CA
,2/6/2023,,Debit,-19.99,,53078123,Payment to Comcast,Cable & Satellite,,161.94,,Bill payment Withdrawal COMCAST CABLE COMM 4899 800-COMCAST CO
,2/5/2023,,Debit,-11.35,,53078122,Kelly Liquors,Groceries,Debit Card,181.93,,Debit Card purchase KELLY LIQUORS 5921 LAS CRUCES NM
,2/3/2023,,Debit,-3,,52982548,Smarty Plus,Online Services,Debit Card,193.28,,Debit Card purchase SMARTYCASHBACK.COM 7278 310-5934557 CA
,2/2/2023,,Debit,-37.87,,52982547,AKTIVLEARNINGPLATFORM 8299 HTTPSAKTIV.CO NY,Clothing,Debit Card,196.28,,Debit Card purchase AKTIVLEARNINGPLATFORM 8299 HTTPSAKTIV.CO NY
,2/2/2023,,Credit,150.12,,52871025,Online banking Deposit Transfer from S0000,Deposits,Transfer,234.15,,Online banking Deposit Transfer from S0000
,2/2/2023,,Debit,-8.53,,52870989,"Ellation, Inc",Entertainment,,84.03,,Bill payment Withdrawal GOOGLE *ELLATION 5816 855-836-3987 CA
,2/1/2023,,Debit,-10.81,,52826525,Whataburger,Restaurants & Dining,Debit Card,92.56,,Debit Card purchase WHATABURGER 465 5814 LAS CRUCES NM
,1/31/2023,,Debit,-83.55,,52745965,Nm Motor Vehicles,Automotive Expenses,Debit Card,103.37,,Debit Card purchase PMT*NM MOTOR VEHICLES 9399 877-818-4323 NM
,1/30/2023,,Debit,-42.81,,52715172,Walmart,Shopping,Debit Card,186.92,,POS Card purchase WAL-MART SUPER CENTER 5411 0806 WAL-SAMS LAS CRUCES NM
,1/30/2023,,Credit,50,,52672464,Online banking Deposit Transfer from S0000,Deposits,Transfer,229.73,,Online banking Deposit Transfer from S0000
,1/30/2023,,Debit,-15.12,,52672450,Marshalls,Shopping,Debit Card,179.73,,POS Card purchase MARSHALLS #802 5310 3050 E LOHMAN AVE STE D LAS CRUCES NM
,1/30/2023,,Debit,-2.64,,52672449,Walmart,Shopping,Debit Card,194.85,,POS Card purchase WAL-MART #0806 5411 571 WALTON BLVD LAS CRUCES NM
,1/30/2023,,Debit,-16.13,,52672448,Walmart,Shopping,Debit Card,197.49,,POS Card purchase WAL-MART SUPER CENTER 5411 0806 WAL-SAMS LAS CRUCES NM
,1/30/2023,,Credit,75,,52663268,ATM Deposit CU ANYTIME XX 1715 EAST UNIVERSITY LAS CRUCES NM,Deposits,,213.62,,ATM Deposit CU ANYTIME 6011 1715 EAST UNIVERSITY LAS CRUCES NM
,1/30/2023,,Debit,-6.19,,52651619,Lowe's,Home Supplies,Debit Card,138.62,,Debit Card purchase LOWE'S #58 5411 LAS CRUCES NM
,1/29/2023,,Debit,-42.43,,52651618,Sprouts Farmers Market,Groceries,Debit Card,144.81,,Debit Card purchase SPROUTS FARMERS MAR 5411 LAS CRUCES NM
,1/29/2023,,Debit,-21.93,,52611965,Starbucks,Restaurants & Dining,Debit Card,187.24,,Debit Card purchase STARBUCKS STORE 11645 5814 LAS CRUCES NM
,1/29/2023,,Debit,-30.21,,52611967,Speedway,Gasoline/Fuel,Debit Card,209.17,,Debit Card purchase SPEEDWAY 09128 1685 E. UN 5542 LAS CRUCES NM
,1/28/2023,,Debit,-245.54,,52611966,AMZN MKTP US*849YU4D93 5942 AMZN.COM/BILL WA,Shopping,Debit Card,239.38,,Debit Card purchase AMZN MKTP US*849YU4D93 5942 AMZN.COM/BILL WA
,1/28/2023,,Debit,-90.91,,52578808,Walmart,Shopping,Debit Card,484.92,,POS Card purchase WAL-MART SUPER CENTER 5411 0806 WAL-SAMS LAS CRUCES NM
,1/28/2023,,Debit,-40,,52575588,ATM Withdrawal CU ANYTIME XX 1715 EAST UNIVERSITY LAS CRUCES NM,ATM/Cash Withdrawals,Debit Card,575.83,,ATM Withdrawal CU ANYTIME 6011 1715 EAST UNIVERSITY LAS CRUCES NM
,1/27/2023,,Debit,-19.8,,52575587,CCSU FOOD CT 5814 LAS CRUCES NM,Groceries,Debit Card,615.83,,Debit Card purchase CCSU FOOD CT 5814 LAS CRUCES NM
,1/24/2023,,Debit,-13.42,,52356661,Panda Express,Restaurants & Dining,Debit Card,635.63,,Debit Card purchase PANDA EXPRESS #2206 5814 LAS CRUCES NM
,1/23/2023,,Debit,-15.25,,52356662,Nmsu Bookstore,Hobbies,Debit Card,649.05,,Debit Card purchase NMSU BOOKSTORE #2218 5942 800-3815151 IL
,1/22/2023,,Debit,-50.74,,52291254,Nmsu Bookstore,Hobbies,Debit Card,664.3,,Debit Card purchase NMSU BOOKSTORE #2218 5942 800-3815151 IL
,1/22/2023,,Debit,-16.72,,52291253,Raising Cane's,Restaurants & Dining,Debit Card,715.04,,Debit Card purchase RAISING CANE'S #340 5814 LAS CRUCES NM
,1/22/2023,,Debit,-16.31,,52241755,Amazon,Shopping,,731.76,,Bill payment Withdrawal AMAZON PRIME*XK5FU7J23 5968 AMZN.COM/BILL WA
,1/21/2023,,Debit,-23.62,,52225851,TST* MATTEOS MEXICAN FOO 5812 LAS CRUCES NM,Restaurants & Dining,Debit Card,748.07,,Debit Card purchase TST* MATTEOS MEXICAN FOO 5812 LAS CRUCES NM
,1/20/2023,,Debit,-26.23,,52171062,Supercuts,Personal Care & Fitness,Debit Card,771.69,,Debit Card purchase SUPERCUTS WALTON 7230 LAS CRUCES NM
,1/20/2023,,Debit,-54.08,,52171065,GNC,Healthcare & Pharmacy,Debit Card,797.92,,Debit Card purchase GNC 5499 LAS CRUCES NM
,1/20/2023,,Debit,-65.02,,52171061,JCPenney,Clothing,Debit Card,852,,Debit Card purchase JCPENNEY 2093 5311 LAS CRUCES NM
,1/20/2023,,Debit,-10.04,,52171064,Alamo Drafthouse,Entertainment,Debit Card,917.02,,Debit Card purchase ALAMO DRAFTHOUSE MONTECIL 7832 EL PASO TX
,1/20/2023,,Debit,-21.47,,52171063,MCW#x386-LUJAN 7542 LAS CRUCES NM,Other Expenses,Debit Card,927.06,,Debit Card purchase MCW#0386-LUJAN 7542 LAS CRUCES NM
,1/19/2023,,Credit,158,,52135672,Online banking Deposit Transfer from S0000,Deposits,Transfer,948.53,,Online banking Deposit Transfer from S0000
,1/19/2023,,Debit,-19.29,,52134522,Taqueria El Cometa,Restaurants & Dining,Debit Card,790.53,,Debit Card purchase TAQUERIA EL COMETA 5812 EL PASO TX
,1/19/2023,,Debit,-12.65,,52125523,Whataburger,Restaurants & Dining,Debit Card,809.82,,Debit Card purchase WHATABURGER 785 5814 LAS CRUCES NM
,1/18/2023,,Credit,100,,52090760,Online banking Deposit Transfer from S0000,Deposits,Transfer,822.47,,Online banking Deposit Transfer from S0000
,1/17/2023,,Debit,-10.82,,52023770,Planet Fitness,Personal Care & Fitness,,722.47,,ACH Withdrawal COMPANY: PLANET FIT ENTRY: CLUB FEES 575-522-7867 ISAIAH MALCOM
,1/16/2023,,Credit,634,,52023769,ATM Deposit CU ANYTIME XX 1715 EAST UNIVERSITY LAS CRUCES NM,Deposits,,733.29,,ATM Deposit CU ANYTIME 6011 1715 EAST UNIVERSITY LAS CRUCES NM
,1/16/2023,,Debit,-4.04,,51945903,Steamgames,Entertainment,Debit Card,99.29,,Debit Card purchase STEAMGAMES.COM 4259522985 5816 425-8899642 WA
,1/15/2023,,Debit,-12.21,,51945902,Wendy's,Restaurants & Dining,Debit Card,103.33,,POS Card purchase WENDY'S 8028 5814 565 WALTON BLVD LAS CRUCES NM
,1/13/2023,,Debit,-46.66,,51945901,Sam's Club,Shopping,Debit Card,115.54,,POS Card purchase SAMSCLUB #4784 5411 2711 NORTH TELSHORE BLV LAS CRUCES NM
,1/13/2023,,Credit,120,,51945900,ATM Deposit CU ANYTIME XX 1715 EAST UNIVERSITY LAS CRUCES NM,Deposits,,162.2,,ATM Deposit CU ANYTIME 6011 1715 EAST UNIVERSITY LAS CRUCES NM
,1/13/2023,,Debit,-150,,51844947,Online banking Withdrawal Transfer to S0000,Transfers,Transfer,42.2,,Online banking Withdrawal Transfer to S0000
,1/13/2023,,Debit,-126.96,,51844276,Amazon,Shopping,Debit Card,192.2,,Debit Card purchase AMZN RENTAL PURCHASE 5942 AMZN.COM/BILL WA
,1/13/2023,,Credit,200,,51844274,Deposit Transfer from SXX00 - Overdraft Transfer,Transfers,Transfer,319.16,,Deposit Transfer from S0000 - Overdraft Transfer
,1/13/2023,,Debit,-10.87,,51844275,Amazon Digital Services,Entertainment,Debit Card,119.16,,Debit Card purchase AMZN DIGITAL*JQ94J7U93 88 5818 888-802-3080 WA
,1/13/2023,,Debit,-157.48,,51844273,Walmart,Shopping,Debit Card,130.03,,Debit Card purchase WAL-MART #0806 5411 LAS CRUCES NM
,1/13/2023,,Debit,-6.52,,51844272,Amazon Digital Services,Entertainment,Debit Card,287.51,,Debit Card purchase AMAZON DIGIT*QI7R967L3 5818 888-802-3080 WA
,1/12/2023,,Debit,-25.09,,51800947,Phillips 66,Gasoline/Fuel,Debit Card,294.03,,Debit Card purchase PHILLIPS 66 - KEWA GAS 1 5542 SANTO DOMINGO NM
,1/12/2023,,Debit,-10.2,,51800946,Panda Express,Restaurants & Dining,Debit Card,319.12,,Debit Card purchase PANDA EXPRESS #1479 5814 LOS LUNAS NM
,1/11/2023,,Debit,-4.22,,51800945,Walmart,Shopping,Debit Card,329.32,,POS Card purchase WAL-MART SUPER CENTER 5411 3596 WAL-SAMS LOS LUNAS NM
,1/10/2023,,Debit,-21.41,,51701314,El Parasol,Restaurants & Dining,Debit Card,333.54,,Debit Card purchase EL PARASOL 5812 ESPANOLA NM
,1/10/2023,,Debit,-9.12,,51701312,McDonald's,Restaurants & Dining,Debit Card,354.95,,POS Card purchase MCDONALD'S F36782 5814 1401 N RIVERSIDE DR ESPANOLA NM
,1/10/2023,,Debit,-26.09,,51701311,AutoZone,Automotive Expenses,Debit Card,364.07,,POS Card purchase AUTOZONE 2520 5533 1331 N RIVERSIDE D ESPANOLA NM
,1/10/2023,,Debit,-19.99,,51701313,Payment to Comcast,Cable & Satellite,,390.16,,Bill payment Withdrawal COMCAST CABLE COMM 4899 800-COMCAST CO
,1/9/2023,,Credit,325,,51652883,ATM Deposit CU ANYTIME XX 1720 N RIVERSIDE DR ESPANOLA NM,Deposits,,410.15,,ATM Deposit CU ANYTIME 6011 1720 N RIVERSIDE DR ESPANOLA NM
,1/9/2023,,Debit,-5.09,,51652882,Phillips 66,Gasoline/Fuel,Debit Card,85.15,,Debit Card purchase PHILLIPS 66 - MALHI C STO 5541 ESPANOLA NM
,1/7/2023,,Debit,-26.35,,51593401,Walmart,Shopping,Debit Card,90.24,,POS Card purchase WAL-MART #2656 5411 1610 NO. RIVERSIDE DRIV ESPANOLA NM
,1/7/2023,,Credit,112.99,,51593402,Debit Deposit VENMO*MALCOM ISAIAH 4829 NEW YORK CITY NY,Transfers,,116.59,,Debit Deposit VENMO*MALCOM ISAIAH 4829 NEW YORK CITY NY
,1/7/2023,,Debit,-12.54,,51529537,Food King,Groceries,Debit Card,3.6,,Debit Card purchase FOOD KING #93 5411 ESPANOLA NM
,1/3/2023,,Debit,-38.06,,51311604,Big 5 Sporting Goods,Shopping,Debit Card,16.14,,Debit Card purchase BIG 5 SPORTING GOODS 499 5941 ESPANOLA NM
,1/3/2023,,Debit,-43.51,,51311603,Big 5 Sporting Goods,Shopping,Debit Card,54.2,,Debit Card purchase BIG 5 SPORTING GOODS 499 5941 ESPANOLA NM
,1/2/2023,,Debit,-80,,51271662,Online banking Withdrawal Transfer to LXX00 - Credit Card,Credit Card Payments,Transfer,97.71,,Online banking Withdrawal Transfer to L0100 - Credit Card Payment
,1/2/2023,,Debit,-18,,51254219,Walmart,Shopping,Debit Card,177.71,,POS Card purchase WAL-MART SUPER CENTER 5411 2656 WAL-SAMS ESPANOLA NM
,1/2/2023,,Credit,210,,51254220,ATM Deposit CU ANYTIME XX 1720 N RIVERSIDE DR ESPANOLA NM,Deposits,,195.71,,ATM Deposit CU ANYTIME 6011 1720 N RIVERSIDE DR ESPANOLA NM
,12/31/2022,,Debit,-61.51,,51212683,OHKAY TRAVEL CENTER 5542 OHKAY OWINGEH NM,Travel & Commute,Debit Card,-14.29,,Debit Card purchase OHKAY TRAVEL CENTER 5542 OHKAY OWINGEH NM
,12/29/2022,,Debit,-10.2,,51091150,Chevron,Gasoline/Fuel,Debit Card,47.22,,Debit Card purchase CHEVRON 0208520 5542 HERNANDEZ NM
,12/29/2022,,Debit,-350,,51071741,Online banking Withdrawal Transfer to LXX00 - Credit Card,Credit Card Payments,Transfer,57.42,,Online banking Withdrawal Transfer to L0100 - Credit Card Payment
,12/29/2022,,Credit,147.38,,51071660,Debit Deposit VENMO*MALCOM ISAIAH 4829 NEW YORK CITY NY,Transfers,,407.42,,Debit Deposit VENMO*MALCOM ISAIAH 4829 NEW YORK CITY NY
,12/29/2022,,Debit,-6,,51070628,Dollar General,Shopping,Debit Card,260.04,,POS Card purchase DOLLAR GENERAL # DG 14151 5310 HERNANDEZ NM
,12/29/2022,,Debit,-61.61,,51070625,Walmart,Shopping,Debit Card,266.04,,POS Card purchase WAL-MART #2656 5411 1610 N RIVERSIDE DR ESPANOLA NM
,12/28/2022,,Debit,-10.11,,51070627,Lowes Fuel,Automotive Expenses,Debit Card,327.65,,POS Card purchase LOWES FUEL 5542 930 N RIVERSIDE DR US ESPANOLA NM
,12/28/2022,,Credit,280,,51070626,ATM Deposit CU ANYTIME XX 1720 N RIVERSIDE DR ESPANOLA NM,Deposits,,337.76,,ATM Deposit CU ANYTIME 6011 1720 N RIVERSIDE DR ESPANOLA NM
,12/24/2022,,Debit,-32.84,,51014680,Walmart,Shopping,Debit Card,57.76,,POS Card purchase WM SUPERCENTER #2656 5411 WAL-MART SUPER CENTER ESPANOLA NM
,12/24/2022,,Debit,-9.4,,51014679,McDonald's,Restaurants & Dining,Debit Card,90.6,,POS Card purchase MCDONALD'S F36782 5814 1401 N RIVERSIDE DR ESPANOLA NM
,12/24/2022,,Credit,100,,50847700,ATM Deposit CU ANYTIME XX 1720 N RIVERSIDE DR ESPANOLA NM,Deposits,,100,,ATM Deposit CU ANYTIME 6011 1720 N RIVERSIDE DR ESPANOLA NM
,12/20/2022,,Debit,-12.35,,50625297,Online banking Withdrawal Transfer to LXX00 - Credit Card,Credit Card Payments,Transfer,0,,Online banking Withdrawal Transfer to L0100 - Credit Card Payment
,12/20/2022,,Credit,12,,50625221,ATM Deposit CU ANYTIME XX 1907 N RIVERSIDE DR ESPANOLA NM,Deposits,,12.35,,ATM Deposit CU ANYTIME 6011 1907 N RIVERSIDE DR ESPANOLA NM
,12/19/2022,,Debit,-54,,50600195,Online banking Withdrawal Transfer to LXX00 - Credit Card,Credit Card Payments,Transfer,0.35,,Online banking Withdrawal Transfer to L0100 - Credit Card Payment
,12/19/2022,,Debit,-20.14,,50600151,Phillips 66,Gasoline/Fuel,Debit Card,54.35,,Debit Card purchase PHILLIPS 66 - SANDIA FUEL 5542 BERNALILLO NM
,12/19/2022,,Debit,-10.82,,50600150,Planet Fitness,Personal Care & Fitness,,74.49,,ACH Withdrawal COMPANY: PLANET FIT ENTRY: CLUB FEES 575-522-7867 ISAIAH MALCOM
,12/19/2022,,Debit,-20.85,,50600148,Starbucks,Restaurants & Dining,Debit Card,85.31,,Debit Card purchase STARBUCKS STORE 11645 5814 LAS CRUCES NM
,12/19/2022,,Debit,-23.56,,50600149,Jimmy John's,Restaurants & Dining,Debit Card,106.16,,Debit Card purchase JIMMY JOHNS - 1912 5814 LAS CRUCES NM
,12/18/2022,,Debit,-4.62,,50600147,Walmart,Shopping,Debit Card,129.72,,POS Card purchase WAL-MART SUPER CENTER 5411 4601 WAL-SAMS LAS CRUCES NM
,12/18/2022,,Debit,-5.18,,50526645,Speedway,Gasoline/Fuel,Debit Card,134.34,,Debit Card purchase SPEEDWAY 09128 1685 E. UN 5542 LAS CRUCES NM
,12/18/2022,,Debit,-6.59,,50526644,Natural Grocers,Groceries,Debit Card,139.52,,Debit Card purchase NATURAL GROCERS LS 5411 LAS CRUCES NM
,12/18/2022,,Debit,-24.87,,50526643,TST* MATTEOS MEXICAN FOO 5812 LAS CRUCES NM,Restaurants & Dining,Debit Card,146.11,,Debit Card purchase TST* MATTEOS MEXICAN FOO 5812 LAS CRUCES NM
,12/17/2022,,Debit,-10.8,,50526642,Amazon,Shopping,Debit Card,170.98,,Debit Card purchase AMZN RENTAL EXTENSION 5942 AMZN.COM/BILL WA
,12/17/2022,,Debit,-23.84,,50526641,Walgreens,Healthcare & Pharmacy,Debit Card,181.78,,POS Card purchase WALGREENS STORE 2700 W PI 5912 LAS CRUCES NM
,12/17/2022,,Credit,200,,50490207,Cash Deposit,Deposits,Deposit,205.62,,Cash Deposit
,12/7/2022,,Debit,-6.9,,49952274,Starbucks,Restaurants & Dining,Debit Card,5.62,,Debit Card purchase STARBUCKS STORE 11645 5814 LAS CRUCES NM
,12/7/2022,,Debit,-19.99,,49952275,Payment to Comcast,Cable & Satellite,,12.52,,Bill payment Withdrawal COMCAST DENVER 4899 800-266-2278 CO
,12/6/2022,,Debit,-42.19,,49917129,Planet Fitness,Personal Care & Fitness,,32.51,,Bill payment Withdrawal ABC*PLANET FITNESS 7997 575-5227867 NM
,12/6/2022,,Debit,-100,,49899478,Online banking Withdrawal Transfer to LXX00 - Credit Card,Credit Card Payments,Transfer,74.7,,Online banking Withdrawal Transfer to L0100 - Credit Card Payment
,12/5/2022,,Credit,196.5,,49876589,Debit Deposit VENMO*MALCOM ISAIAH 4829 NEW YORK CITY NY,Transfers,,174.7,,Debit Deposit VENMO*MALCOM ISAIAH 4829 NEW YORK CITY NY
,12/1/2022,,Debit,-30,,49669275,Planet Fitness Service Charges/Fees,Service Charges & Fees,Fees,-21.8,,Fee Withdrawal COMPANY: PLANET FIT ENTRY: CLUB FEES 575-522-7867 ISAIAH MALCOM - NSF Fee
,11/29/2022,,Debit,-10.38,,49424265,Whataburger,Restaurants & Dining,Debit Card,8.2,,Debit Card purchase WHATABURGER 785 5814 LAS CRUCES NM
,11/28/2022,,Debit,-7.44,,49424264,Starbucks,Restaurants & Dining,Debit Card,18.58,,Debit Card purchase STARBUCKS STORE 06642 5814 EL PASO TX
,11/28/2022,,Debit,-16.07,,49424267,Cinemark Theatres,Entertainment,Debit Card,26.02,,Debit Card purchase CNK*CINEMARK.COM 236 7832 800-246-3627 TX
,11/28/2022,,Debit,-30.48,,49424266,Speedway,Gasoline/Fuel,Debit Card,42.09,,Debit Card purchase SPEEDWAY 09128 1685 E. UN 5542 LAS CRUCES NM
,11/27/2022,,Debit,-6.9,,49342137,Starbucks,Restaurants & Dining,Debit Card,72.57,,Debit Card purchase STARBUCKS STORE 11645 5814 LAS CRUCES NM
,11/26/2022,,Credit,100,,49284522,ATM Deposit CU ANYTIME XX 1715 EAST UNIVERSITY LAS CRUCES NM,Deposits,,79.47,,ATM Deposit CU ANYTIME 6011 1715 EAST UNIVERSITY LAS CRUCES NM
,11/17/2022,,Debit,-30,,48930095,Planet Fitness Service Charges/Fees,Service Charges & Fees,Fees,-20.53,,Fee Withdrawal COMPANY: PLANET FIT ENTRY: CLUB FEES 575-522-7867 ISAIAH MALCOM - NSF Fee
,11/15/2022,,Debit,-90,,48740510,Online banking Withdrawal Transfer to LXX00 - Credit Card,Credit Card Payments,Transfer,9.47,,Online banking Withdrawal Transfer to L0100 - Credit Card Payment
,11/15/2022,,Debit,-100,,48740433,Online banking Withdrawal Transfer to LXX00 - Credit Card,Credit Card Payments,Transfer,99.47,,Online banking Withdrawal Transfer to L0100 - Credit Card Payment
,11/13/2022,,Debit,-31.23,,48641803,Supercuts,Personal Care & Fitness,Debit Card,199.47,,Debit Card purchase SUPERCUTS LAS CRUCES II 7230 LAS CRUCES NM
,11/13/2022,,Credit,200,,48641802,Deposit Transfer from SXX00 - Overdraft Transfer,Transfers,Transfer,230.7,,Deposit Transfer from S0000 - Overdraft Transfer
,11/13/2022,,Debit,-10.87,,48641804,PRIME VIDEO*HB4O74B61 XX-3080 WA,Entertainment,Debit Card,30.7,,Debit Card purchase PRIME VIDEO*HB4O74B61 5818 888-802-3080 WA
,11/12/2022,,Debit,-60.43,,48613097,Walmart,Shopping,Debit Card,41.57,,POS Card purchase WAL-MART #0806 5411 571 WALTON BLVD LAS CRUCES NM
,11/12/2022,,Debit,-200,,48602670,Online banking Withdrawal Transfer to LXX00 - Credit Card,Credit Card Payments,Transfer,102,,Online banking Withdrawal Transfer to L0100 - Credit Card Payment
,11/12/2022,,Debit,-200,,48602661,Online banking Withdrawal Transfer to S0000,Transfers,Transfer,302,,Online banking Withdrawal Transfer to S0000
,11/12/2022,,Credit,500,,48598519,Check Deposit,Deposits,Deposit,502,,Check Deposit
,11/9/2022,,Credit,2,,48598518,ATM Deposit CU ANYTIME XX 1715 EAST UNIVERSITY LAS CRUCES NM,Deposits,,2,,ATM Deposit CU ANYTIME 6011 1715 EAST UNIVERSITY LAS CRUCES NM
,10/31/2022,,Debit,-10.17,,47964699,Online banking Withdrawal Transfer to LXX00 - Credit Card,Credit Card Payments,Transfer,0,,Online banking Withdrawal Transfer to L0100 - Credit Card Payment
,10/17/2022,,Debit,-10.82,,47247501,Planet Fitness,Personal Care & Fitness,,10.17,,ACH Withdrawal COMPANY: PLANET FIT ENTRY: CLUB FEES 575-522-7867 ISAIAH MALCOM
,10/15/2022,,Debit,-5.81,,47247500,Nmsu Bookstore,Hobbies,Debit Card,20.99,,Debit Card purchase NMSU BOOKSTORE #2218 5942 LAS CRUCES NM
,10/15/2022,,Debit,-13.81,,47247499,Nmsu Bookstore,Hobbies,Debit Card,26.8,,Debit Card purchase NMSU BOOKSTORE #2218 5942 LAS CRUCES NM
,10/15/2022,,Debit,-39.98,,47152001,Payment to Comcast,Cable & Satellite,,40.61,,Bill payment Withdrawal COMCAST DENVER 4899 800-266-2278 CO
,10/15/2022,,Debit,-11.67,,47152000,Whataburger,Restaurants & Dining,Debit Card,80.59,,Debit Card purchase WHATABURGER 785 5814 LAS CRUCES NM
,10/14/2022,,Debit,-3.5,,47099828,NMSUTRANSPORTPRKNGSRVCS XX1839 NM,Travel & Commute,Debit Card,92.26,,Debit Card purchase NMSUTRANSPORTPRKNGSRVCS 8220 5756461839 NM
,10/14/2022,,Debit,-14,,47099827,Panda Express,Restaurants & Dining,Debit Card,95.76,,Debit Card purchase PANDA EXPRESS #2206 5814 LAS CRUCES NM
,10/13/2022,,Debit,-700,,47099826,Online banking Withdrawal Transfer to LXX00 - Credit Card,Credit Card Payments,Transfer,109.76,,Online banking Withdrawal Transfer to L0100 - Credit Card Payment
,10/13/2022,,Credit,800,,47056083,Check Deposit,Deposits,Deposit,809.76,,Check Deposit
,10/13/2022,,Debit,-6.22,,47056082,Starbucks,Restaurants & Dining,Debit Card,9.76,,Debit Card purchase STARBUCKS STORE 11645 5814 LAS CRUCES NM
,10/13/2022,,Debit,-2.5,,47035588,NMSUTRANSPORTPRKNGSRVCS XX1839 NM,Travel & Commute,Debit Card,15.98,,Debit Card purchase NMSUTRANSPORTPRKNGSRVCS 8220 5756461839 NM
,10/13/2022,,Debit,-10.87,,47035587,PRIME VIDEO*HT1IB5451 XX-3080 WA,Entertainment,Debit Card,18.48,,Debit Card purchase PRIME VIDEO*HT1IB5451 5818 888-802-3080 WA
,10/10/2022,,Debit,-24.75,,46939693,Peter Piper Pizza,Restaurants & Dining,Debit Card,29.35,,Debit Card purchase PETER PIPER PIZZA 45 5812 LAS CRUCES NM
,10/9/2022,,Debit,-47.26,,46875572,Circle K,Groceries,Debit Card,54.1,,POS Card purchase CIRCLE K # 41289 5542 LAS CRUCES NM
,10/9/2022,,Debit,-55.74,,46875571,Walmart,Shopping,Debit Card,101.36,,POS Card purchase WAL-MART #0806 5411 571 WALTON BLVD LAS CRUCES NM
,10/9/2022,,Debit,-16.2,,46875570,Chick-fil-A,Restaurants & Dining,Debit Card,157.1,,Debit Card purchase CHICK-FIL-A #03693 5814 LAS CRUCES NM
,10/9/2022,,Debit,-1.08,,46866903,Planet Fitness,Personal Care & Fitness,Debit Card,173.3,,Debit Card purchase 7038 PLANET FITNESS 7997 LAS CRUCES NM
,10/8/2022,,Debit,-24.35,,46866902,Walmart,Shopping,Debit Card,174.38,,POS Card purchase WAL-MART #0806 5411 571 WALTON BLVD LAS CRUCES NM
,10/8/2022,,Credit,196.5,,46827936,Debit Deposit VENMO*MALCOM ISAIAH 4829 NEW YORK CITY NY,Transfers,,198.73,,Debit Deposit VENMO*MALCOM ISAIAH 4829 NEW YORK CITY NY
,10/4/2022,,Debit,-27.71,,46654017,Walmart,Shopping,Debit Card,2.23,,POS Card purchase WAL-MART SUPER CENTER 5411 0806 WAL-SAMS LAS CRUCES NM
,10/4/2022,,Debit,-6.22,,46611317,Starbucks,Restaurants & Dining,Debit Card,29.94,,Debit Card purchase STARBUCKS STORE 11645 5814 LAS CRUCES NM
,10/1/2022,,Debit,-4.92,,46538141,Starbucks,Restaurants & Dining,Debit Card,36.16,,Debit Card purchase STARBUCKS STORE 11645 5814 LAS CRUCES NM
,10/1/2022,,Debit,-5,,46538142,Speedway,Gasoline/Fuel,Debit Card,41.08,,Debit Card purchase SPEEDWAY 09128 1685 E. UN 5541 LAS CRUCES NM
,9/23/2022,,Debit,-6.22,,46074706,Starbucks,Restaurants & Dining,Debit Card,46.08,,Debit Card purchase STARBUCKS STORE 11645 5814 LAS CRUCES NM
,9/23/2022,,Debit,-1,,46074707,NMSUTRANSPORTPRKNGSRVCS XX1839 NM,Travel & Commute,Debit Card,52.3,,Debit Card purchase NMSUTRANSPORTPRKNGSRVCS 8220 5756461839 NM
,9/22/2022,,Debit,-16.31,,45984962,Amazon,Shopping,,53.3,,Bill payment Withdrawal AMAZON PRIME*1U11A2JN1 5968 AMZN.COM/BILL WA
,9/21/2022,,Debit,-1,,45926164,NMSUTRANSPORTPRKNGSRVCS XX1839 NM,Travel & Commute,Debit Card,69.61,,Debit Card purchase NMSUTRANSPORTPRKNGSRVCS 8220 5756461839 NM
,9/19/2022,,Debit,-48.29,,45856849,Shell,Gasoline/Fuel,Debit Card,70.61,,Debit Card purchase SHELL OIL 53047880207 5542 LAS CRUCES NM
,9/19/2022,,Debit,-6.22,,45856848,Starbucks,Restaurants & Dining,Debit Card,118.9,,Debit Card purchase STARBUCKS STORE 11645 5814 LAS CRUCES NM
,9/18/2022,,Debit,-51.95,,45856847,Walmart,Shopping,Debit Card,125.12,,POS Card purchase WAL-MART #0806 5411 571 WALTON BLVD LAS CRUCES NM
,9/18/2022,,Debit,-800,,45741864,Online banking Withdrawal Transfer to LXX00 - Credit Card,Credit Card Payments,Transfer,177.07,,Online banking Withdrawal Transfer to L0100 - Credit Card Payment
,9/18/2022,,Debit,-3.35,,45741770,Pepsi Vending Machines,Groceries,Debit Card,977.07,,Debit Card purchase 2575PEPSIVEN9147678600 5814 LAS CRUCES NM
,9/17/2022,,Debit,-25.18,,45741768,Walmart,Shopping,Debit Card,980.42,,POS Card purchase WAL-MART #0806 5411 571 WALTON BLVD LAS CRUCES NM
,9/17/2022,,Debit,-6.26,,45741769,Wendy's,Restaurants & Dining,Debit Card,1005.6,,POS Card purchase WENDY'S 8028 5814 565 WALTON BLVD LAS CRUCES NM
,9/17/2022,,Credit,1000,,45703549,Check Deposit,Deposits,Deposit,1011.86,,Check Deposit
,9/16/2022,,Debit,-8.54,,45659651,Whataburger,Restaurants & Dining,Debit Card,11.86,,Debit Card purchase WHATABURGER 465 5814 LAS CRUCES NM
,9/15/2022,,Debit,-3.72,,45607472,CCSU FOOD CT 5814 LAS CRUCES NM,Groceries,Debit Card,20.4,,Debit Card purchase CCSU FOOD CT 5814 LAS CRUCES NM
,9/15/2022,,Debit,-12,,45607471,Panda Express,Restaurants & Dining,Debit Card,24.12,,Debit Card purchase PANDA EXPRESS #2206 5814 LAS CRUCES NM
,9/14/2022,,Debit,-10.43,,45546337,CCSU FOOD CT 5814 LAS CRUCES NM,Groceries,Debit Card,36.12,,Debit Card purchase CCSU FOOD CT 5814 LAS CRUCES NM
,9/13/2022,,Debit,-50,,45480509,Online banking Withdrawal Transfer to LXX00 - Credit Card,Credit Card Payments,Transfer,46.55,,Online banking Withdrawal Transfer to L0100 - Credit Card Payment
,9/12/2022,,Debit,-3.12,,45480506,Walmart,Shopping,Debit Card,96.55,,POS Card purchase WM SUPERCENTER #806 5411 WAL-MART SUPER CENTER LAS CRUCES NM
,9/12/2022,,Credit,99.24,,45480507,Debit Deposit VENMO*MALCOM ISAIAH 4829 NEW YORK CITY NY,Transfers,,99.67,,Debit Deposit VENMO*MALCOM ISAIAH 4829 NEW YORK CITY NY
,9/3/2022,,Debit,-24,,45033357,Online banking Withdrawal Transfer to LXX00 - Credit Card,Credit Card Payments,Transfer,0.43,,Online banking Withdrawal Transfer to L0100 - Credit Card Payment
,8/23/2022,,Debit,-500,,44390789,Online banking Withdrawal Transfer to LXX00 - Credit Card,Credit Card Payments,Transfer,24.43,,Online banking Withdrawal Transfer to L0100 - Credit Card Payment
,8/22/2022,,Debit,-16.31,,44390735,Amazon,Shopping,,524.43,,Bill payment Withdrawal AMAZON PRIME*7H9326QL3 5968 AMZN.COM/BILL WA
,8/21/2022,,Debit,-6.22,,44390734,Starbucks,Restaurants & Dining,Debit Card,540.74,,Debit Card purchase STARBUCKS STORE 02774 5814 LAS CRUCES NM
,8/19/2022,,Debit,-19.66,,44247046,Walmart,Shopping,Debit Card,546.96,,POS Card purchase WAL-MART SUPER CENTER 5411 0806 WAL-SAMS LAS CRUCES NM
,8/19/2022,,Credit,400,,44233154,Cash Deposit,Deposits,Deposit,566.62,,Cash Deposit
,8/19/2022,,Debit,-11.02,,44233153,Whataburger,Restaurants & Dining,Debit Card,166.62,,Debit Card purchase WHATABURGER 785 5814 LAS CRUCES NM
,8/17/2022,,Debit,-802.15,,44109672,Online banking Withdrawal Transfer to LXX00 - Credit Card,Credit Card Payments,Transfer,177.64,,Online banking Withdrawal Transfer to L0100 - Credit Card Payment
,8/16/2022,,Debit,-77.17,,44109601,Walmart,Shopping,Debit Card,979.79,,POS Card purchase WAL-MART #0806 5411 571 WALTON BLVD LAS CRUCES NM
,8/16/2022,,Credit,1040,,44109603,ATM Deposit CU ANYTIME XX 1715 EAST UNIVERSITY LAS CRUCES NM,Deposits,,1056.96,,ATM Deposit CU ANYTIME 6011 1715 EAST UNIVERSITY LAS CRUCES NM
,8/13/2022,,Debit,-10.87,,44109602,PRIME VIDEO*S100V9XY3 XX-3080 WA,Entertainment,Debit Card,16.96,,Debit Card purchase PRIME VIDEO*S100V9XY3 5818 888-802-3080 WA
,8/6/2022,,Debit,-81.96,,44109600,Walmart,Shopping,Debit Card,27.83,,POS Card purchase WAL-MART #2656 5411 1610 NO. RIVERSIDE DRIV ESPANOLA NM
,8/4/2022,,Debit,-29.59,,43458728,Great Clips,Personal Care & Fitness,Debit Card,109.79,,Debit Card purchase 0646 GREAT CLIPS AT ESPAN 7230 ESPANOLA NM
,8/3/2022,,Credit,39.3,,43458727,Debit Deposit VENMO*MALCOM ISAIAH 4829 NEW YORK CITY NY,Transfers,,139.38,,Debit Deposit VENMO*MALCOM ISAIAH 4829 NEW YORK CITY NY
,8/3/2022,,Debit,-900,,43377767,Online banking Withdrawal Transfer to LXX00 - Credit Card,Credit Card Payments,Transfer,100.08,,Online banking Withdrawal Transfer to L0100 - Credit Card Payment
,8/3/2022,,Credit,1000,,43377730,ATM Deposit CU ANYTIME XX 1907 N. RIVERSIDE DR ESPANOLA NM,Deposits,,1000.08,,ATM Deposit CU ANYTIME 6011 1907 N. RIVERSIDE DR ESPANOLA NM
,7/18/2022,,Debit,-60,,42525288,Online banking Withdrawal Transfer to LXX00 - Credit Card,Credit Card Payments,Transfer,0.08,,Online banking Withdrawal Transfer to L0100 - Credit Card Payment
,7/18/2022,,Credit,60,,42525221,ACH Deposit COMPANY: VENMO ENTRY: CASHOUT ISAIAH MALCOM,Transfers,ACH,60.08,,ACH Deposit COMPANY: VENMO ENTRY: CASHOUT ISAIAH MALCOM
,7/10/2022,,Debit,-10.66,,42212825,Lowe's,Home Supplies,Debit Card,0.08,,Debit Card purchase LOWES #02510* 5200 ESPANOLA NM
,7/10/2022,,Debit,-24.36,,42212824,McDonald's,Restaurants & Dining,Debit Card,10.74,,Debit Card purchase MCDONALD'S F2279 5814 SANTA FE NM
,7/10/2022,,Debit,-26,,42074610,Online banking Withdrawal Transfer to LXX00 - Credit Card,Credit Card Payments,Transfer,35.1,,Online banking Withdrawal Transfer to L0100 - Credit Card Payment
,7/10/2022,,Credit,26,,42074593,ATM Deposit CU ANYTIME XX 1216 PASEO DE ONATE ESPANOLA NM,Deposits,,61.1,,ATM Deposit CU ANYTIME 6011 1216 PASEO DE ONATE ESPANOLA NM
,7/9/2022,,Debit,-44.16,,42072883,The Home Depot,Home Supplies,Debit Card,35.1,,POS Card purchase THE HOME DEPOT #3503 5200 952 RICHARDS AVE. SANTA FE NM
,7/9/2022,,Credit,78.6,,42072884,Debit Deposit VENMO*MALCOM ISAIAH 4829 NEW YORK CITY NY,Transfers,,79.26,,Debit Deposit VENMO*MALCOM ISAIAH 4829 NEW YORK CITY NY
,7/6/2022,,Debit,-20,,41883892,Online banking Withdrawal Transfer to LXX00 - Credit Card,Credit Card Payments,Transfer,0.66,,Online banking Withdrawal Transfer to L0100 - Credit Card Payment
,7/6/2022,,Credit,20,,41883813,ATM Deposit CU ANYTIME XX 1907 N. RIVERSIDE DR ESPANOLA NM,Deposits,,20.66,,ATM Deposit CU ANYTIME 6011 1907 N. RIVERSIDE DR ESPANOLA NM
,7/4/2022,,Debit,-65,,41771198,Online banking Withdrawal Transfer to LXX00 - Credit Card,Credit Card Payments,Transfer,0.66,,Online banking Withdrawal Transfer to L0100 - Credit Card Payment
,7/4/2022,,Credit,41,,41771172,ATM Deposit CU ANYTIME XX 1907 N. RIVERSIDE DR ESPANOLA NM,Deposits,,65.66,,ATM Deposit CU ANYTIME 6011 1907 N. RIVERSIDE DR ESPANOLA NM
,7/3/2022,,Debit,-40.07,,41769117,Phillips 66,Gasoline/Fuel,Debit Card,24.66,,Debit Card purchase PHILLIPS 66 - MALHI C STO 5542 ESPANOLA NM
,7/3/2022,,Debit,-70,,41731388,Online banking Withdrawal Transfer to LXX00 - Credit Card,Credit Card Payments,Transfer,64.73,,Online banking Withdrawal Transfer to L0100 - Credit Card Payment
,7/3/2022,,Debit,-17.55,,41729356,Walmart,Shopping,Debit Card,134.73,,POS Card purchase WM SUPERCENTER # 5411 WAL-MART SUPER CENTER ESPANOLA NM
,7/3/2022,,Debit,-5.83,,41729355,Walmart,Shopping,Debit Card,152.28,,POS Card purchase WAL-MART SUPER CENTER 5411 2656 WAL-SAMS ESPANOLA NM
,7/3/2022,,Debit,-47.75,,41729354,Shell,Gasoline/Fuel,Debit Card,158.11,,Debit Card purchase SHELL OIL 53047880207 5542 LAS CRUCES NM
,7/3/2022,,Debit,-3.81,,41729357,Marathon Petroleum,Gasoline/Fuel,Debit Card,205.86,,Debit Card purchase MARATHON PETRO235069 5541 LEMITAR NM
,7/3/2022,,Debit,-4.84,,41729353,Starbucks,Restaurants & Dining,Debit Card,209.67,,Debit Card purchase STARBUCKS STORE 50626 5814 ESPANOLA NM
,7/3/2022,,Debit,-10.62,,41729352,McDonald's,Restaurants & Dining,Debit Card,214.51,,Debit Card purchase MCDONALD'S F20533 5814 LAS CRUCES NM
,7/1/2022,,Credit,200,,41687845,Cash Deposit,Deposits,Deposit,225.13,,Cash Deposit
,7/1/2022,,Debit,-6.23,,41687844,Starbucks,Restaurants & Dining,Debit Card,25.13,,Debit Card purchase STARBUCKS STORE 11645 5814 LAS CRUCES NM
,7/1/2022,,Debit,-10.17,,41687843,Whataburger,Restaurants & Dining,Debit Card,31.36,,Debit Card purchase WHATABURGER 785 5814 LAS CRUCES NM
,6/28/2022,,Debit,-250,,41447952,Online banking Withdrawal Transfer to LXX00 - Credit Card,Credit Card Payments,Transfer,41.53,,Online banking Withdrawal Transfer to L0100 - Credit Card Payment
,6/28/2022,,Debit,-18.8,,41447944,Walmart,Shopping,Debit Card,291.53,,POS Card purchase WM SUPERCENTER # 5411 WAL-MART SUPER CENTER LAS CRUCES NM
,6/28/2022,,Credit,300,,41446657,ATM Deposit CU ANYTIME XX 1715 E. UNIVERSITY AVE LAS CRUCES NM,Deposits,,310.33,,ATM Deposit CU ANYTIME 6011 1715 E. UNIVERSITY AVE LAS CRUCES NM
,6/22/2022,,Debit,-3.35,,41256107,Pepsi Vending Machines,Groceries,Debit Card,10.33,,Debit Card purchase 2575PEPSIVEN9147678600 5814 LAS CRUCES NM
,6/22/2022,,Debit,-3.35,,41256106,Pepsi Vending Machines,Groceries,Debit Card,13.68,,Debit Card purchase 2575PEPSIVEN9147678600 5814 LAS CRUCES NM
,6/22/2022,,Debit,-16.33,,41256105,Amazon,Shopping,,17.03,,Bill payment Withdrawal AMAZON PRIME*332CO0G43 5968 AMZN.COM/BILL WA
,6/19/2022,,Debit,-2.75,,40986487,"CARLSBAD CAVERN SNACK BA 5814 CARLSBAD, NM",Restaurants & Dining,Debit Card,33.36,,"Debit Card purchase CARLSBAD CAVERN SNACK BA 5814 CARLSBAD, NM"
,6/19/2022,,Debit,-15,,40986486,Carlsbad Tavern,Entertainment,Debit Card,36.11,,Debit Card purchase CARLSBAD CAVERNS 9399 CARLSBAD NM
,6/17/2022,,Debit,-6.23,,40902442,Starbucks,Restaurants & Dining,Debit Card,51.11,,Debit Card purchase STARBUCKS STORE 11645 5814 LAS CRUCES NM
,6/16/2022,,Debit,-13.52,,40902441,Walmart,Shopping,Debit Card,57.34,,POS Card purchase WM SUPERCENTER # 5411 WAL-MART SUPER CEN LAS CRUCES NM
,6/16/2022,,Debit,-300,,40855170,Online banking Withdrawal Transfer to LXX00 - Credit Card,Credit Card Payments,Transfer,70.86,,Online banking Withdrawal Transfer to L0100 - Credit Card Payment
,6/16/2022,,Credit,358.52,,40853224,Online banking Deposit - Remote deposit,Deposits,,370.86,,Online banking Deposit - Remote deposit
,6/15/2022,,Debit,-3.35,,40789086,Pepsi Vending Machines,Groceries,Debit Card,12.34,,Debit Card purchase 2575PEPSIVEN9147678600 5814 LAS CRUCES NM
,6/14/2022,,Debit,-10.89,,40708830,McDonald's,Restaurants & Dining,Debit Card,15.69,,Debit Card purchase MCDONALD'S F20533 5814 LAS CRUCES NM
,6/13/2022,,Debit,-10.88,,40657568,Amazon Digital Services,Entertainment,Debit Card,26.58,,Debit Card purchase PRIME VIDEO*032DC41Q3 5818 888-802-3080 WA
,6/12/2022,,Debit,-13,,40657567,Panda Express,Restaurants & Dining,Debit Card,37.46,,Debit Card purchase PANDA EXPRESS #2206 5814 LAS CRUCES NM
,6/11/2022,,Debit,-450,,40586150,Online banking Withdrawal Transfer to LXX00 - Credit Card,Credit Card Payments,Transfer,50.46,,Online banking Withdrawal Transfer to L0100 - Credit Card Payment
,6/11/2022,,Credit,500,,40582093,Check Deposit,Deposits,Deposit,500.46,,Check Deposit
,6/7/2022,,Debit,-39,,40370508,Online banking Withdrawal Transfer to LXX00 - Credit Card,Credit Card Payments,Transfer,0.46,,Online banking Withdrawal Transfer to L0100 - Credit Card Payment
,6/7/2022,,Debit,-3.51,,40369230,Einstein Bros. Bagels,Restaurants & Dining,Debit Card,39.46,,Debit Card purchase EINSTEINS CCSU 5814 LAS CRUCES NM
,6/7/2022,,Debit,-10.18,,40369228,Panda Express,Restaurants & Dining,Debit Card,42.97,,Debit Card purchase PANDA EXPRESS #2206 5814 LAS CRUCES NM
,6/7/2022,,Debit,-191.5,,40369229,NMSU CASHNET XX-2046 NM,Clothing,Debit Card,53.15,,Debit Card purchase NMSU CASHNET 8220 575-646-2046 NM
,6/6/2022,,Debit,-150,,40344736,Online banking Withdrawal Transfer to LXX00 - Credit Card,Credit Card Payments,Transfer,244.65,,Online banking Withdrawal Transfer to L0100 - Credit Card Payment
,6/4/2022,,Credit,392.22,,40201394,Online banking Deposit - Remote deposit,Deposits,,394.65,,Online banking Deposit - Remote deposit
,5/29/2022,,Debit,-8.39,,39867145,Starbucks,Restaurants & Dining,Debit Card,2.43,,Debit Card purchase STARBUCKS STORE 11645 5814 LAS CRUCES NM
,5/29/2022,,Debit,-490,,39848967,Online banking Withdrawal Transfer to LXX00 - Credit Card,Credit Card Payments,Transfer,10.82,,Online banking Withdrawal Transfer to L0100 - Credit Card Payment
,5/28/2022,,Debit,-31.25,,39829709,Supercuts,Personal Care & Fitness,Debit Card,500.82,,Debit Card purchase SUPERCUTS LAS CRUCES II 7230 LAS CRUCES NM
,5/27/2022,,Credit,500,,39795709,Check Deposit,Deposits,Deposit,532.07,,Check Deposit
,5/26/2022,,Debit,-3.35,,39722612,Pepsi Vending Machines,Groceries,Debit Card,32.07,,Debit Card purchase 2575PEPSIVEN9147678600 5814 LAS CRUCES NM
,5/25/2022,,Debit,-6.23,,39722611,Starbucks,Restaurants & Dining,Debit Card,35.42,,Debit Card purchase STARBUCKS STORE 11645 5814 LAS CRUCES NM
,5/24/2022,,Debit,-11.26,,39603284,Blake's Lotaburger,Restaurants & Dining,Debit Card,41.65,,Debit Card purchase BLAKE S LOTABURGER - 033 5814 LAS CRUCES NM
,5/23/2022,,Debit,-4.06,,39569921,Starbucks,Restaurants & Dining,Debit Card,52.91,,Debit Card purchase STARBUCKS STORE 11645 5814 LAS CRUCES NM
,5/22/2022,,Debit,-6.23,,39569920,Starbucks,Restaurants & Dining,Debit Card,56.97,,Debit Card purchase STARBUCKS STORE 11645 5814 LAS CRUCES NM
,5/22/2022,,Debit,-16.33,,39569919,Amazon,Shopping,,63.2,,Bill payment Withdrawal AMAZON PRIME*1L7Q15Y80 5968 AMZN.COM/BILL WA
,5/22/2022,,Debit,-10.82,,39569918,Whataburger,Restaurants & Dining,Debit Card,79.53,,Debit Card purchase WHATABURGER 465 5814 LAS CRUCES NM
,5/21/2022,,Debit,-17.05,,39569917,Walmart,Shopping,Debit Card,90.35,,POS Card purchase WM SUPERCENTER # 5411 WAL-MART SUPER CENTER LAS CRUCES NM
,5/20/2022,,Debit,-300,,39456237,Online banking Withdrawal Transfer to LXX00 - Credit Card,Credit Card Payments,Transfer,107.4,,Online banking Withdrawal Transfer to L0100 - Credit Card Payment
,5/20/2022,,Credit,404.92,,39456215,Online banking Deposit - Remote deposit,Deposits,,407.4,,Online banking Deposit - Remote deposit
,5/11/2022,,Debit,-60,,38961185,Online banking Withdrawal Transfer to LXX00 - Credit Card,Credit Card Payments,Transfer,2.48,,Online banking Withdrawal Transfer to L0100 - Credit Card Payment
,5/11/2022,,Debit,-4.06,,38961154,Starbucks,Restaurants & Dining,Debit Card,62.48,,Debit Card purchase STARBUCKS STORE 11645 5814 LAS CRUCES NM
,5/10/2022,,Debit,-49.22,,38961153,Walmart,Shopping,Debit Card,66.54,,POS Card purchase WM SUPERCENTER # 5411 WAL-MART SUPER CENTER LAS CRUCES NM
,5/10/2022,,Credit,100,,38895300,Cash Deposit,Deposits,Deposit,115.76,,Cash Deposit
,5/10/2022,,Debit,-6.23,,38895299,Starbucks,Restaurants & Dining,Debit Card,15.76,,Debit Card purchase STARBUCKS STORE 11645 5814 LAS CRUCES NM
,5/9/2022,,Debit,-35.74,,38885608,Walmart,Shopping,Debit Card,21.99,,POS Card purchase WAL-MART #0806 5411 571 WALTON BLVD LAS CRUCES NM
,5/9/2022,,Debit,-9.97,,38850320,McDonald's,Restaurants & Dining,Debit Card,57.73,,Debit Card purchase MCDONALD'S F20533 5814 LAS CRUCES NM
,5/8/2022,,Debit,-9.67,,38850323,Speedway,Gasoline/Fuel,Debit Card,67.7,,POS Card purchase SPEEDWAY 5541 1685 E UNIVERSITY AVE LAS CRUCES NM
,5/8/2022,,Debit,-11.26,,38850322,Blake's Lotaburger,Restaurants & Dining,Debit Card,77.37,,Debit Card purchase BLAKE S LOTABURGER - 028 5814 LAS CRUCES NM
,5/8/2022,,Debit,-48.77,,38850321,Speedway,Gasoline/Fuel,Debit Card,88.63,,Debit Card purchase SPEEDWAY 09128 1685 E. UN 5542 LAS CRUCES NM
,5/7/2022,,Debit,-200,,38777496,Online banking Withdrawal Transfer to LXX00 - Credit Card,Credit Card Payments,Transfer,137.4,,Online banking Withdrawal Transfer to L0100 - Credit Card Payment
,5/7/2022,,Credit,336.68,,38777420,Online banking Deposit - Remote deposit,Deposits,,337.4,,Online banking Deposit - Remote deposit
,4/29/2022,,Debit,-62,,38356429,Online banking Withdrawal Transfer to LXX00 - Credit Card,Credit Card Payments,Transfer,0.72,,Online banking Withdrawal Transfer to L0100 - Credit Card Payment
,4/29/2022,,Debit,-3.68,,38356395,NMSU BOOKSTORE #XX 5942 LAS CRUCES NM,Hobbies,Debit Card,62.72,,Debit Card purchase NMSU BOOKSTORE #2218 5942 LAS CRUCES NM
,4/29/2022,,Debit,-10.94,,38352653,Panda Express,Restaurants & Dining,Debit Card,66.4,,Debit Card purchase PANDA EXPRESS #2206 5814 LAS CRUCES NM
,4/28/2022,,Debit,-3.74,,38299756,Starbucks,Restaurants & Dining,Debit Card,77.34,,Debit Card purchase STARBUCKS STORE 11645 5814 LAS CRUCES NM
,4/27/2022,,Debit,-5.69,,38246939,Starbucks,Restaurants & Dining,Debit Card,81.08,,Debit Card purchase STARBUCKS STORE 11645 5814 LAS CRUCES NM
,4/27/2022,,Debit,-9.36,,38246940,CCSU FOOD CT 5814 LAS CRUCES NM,Groceries,Debit Card,86.77,,Debit Card purchase CCSU FOOD CT 5814 LAS CRUCES NM
,4/27/2022,,Debit,-10.24,,38246938,McDonald's,Restaurants & Dining,Debit Card,96.13,,Debit Card purchase MCDONALD'S F6849 5814 LAS CRUCES NM
,4/26/2022,,Debit,-8.07,,38246937,Starbucks,Restaurants & Dining,Debit Card,106.37,,Debit Card purchase STARBUCKS STORE 11645 5814 LAS CRUCES NM
,4/25/2022,,Debit,-3.74,,38138516,Starbucks,Restaurants & Dining,Debit Card,114.44,,Debit Card purchase STARBUCKS STORE 11645 5814 LAS CRUCES NM
,4/25/2022,,Debit,-10.9,,38138515,Walmart,Shopping,Debit Card,118.18,,POS Card purchase WAL-MART #0806 5411 571 WALTON BLVD LAS CRUCES NM
,4/24/2022,,Debit,-11.26,,38099430,Blake's Lotaburger,Restaurants & Dining,Debit Card,129.08,,Debit Card purchase BLAKE S LOTABURGER - 028 5814 LAS CRUCES NM
,4/24/2022,,Debit,-3.35,,38099429,Pepsi Vending Machines,Groceries,Debit Card,140.34,,Debit Card purchase 2575PEPSIVEN9147678600 5814 LAS CRUCES NM
,4/22/2022,,Debit,-6.16,,38011561,Wendy's,Restaurants & Dining,Debit Card,143.69,,POS Card purchase WENDY'S 8028 5814 565 WALTON BLVD LAS CRUCES NM
,4/22/2022,,Debit,-150,,38008510,Online banking Withdrawal Transfer to LXX00 - Credit Card,Credit Card Payments,Transfer,149.85,,Online banking Withdrawal Transfer to L0100 - Credit Card Payment
,4/22/2022,,Credit,299.85,,38006102,Online banking Deposit - Remote deposit,Deposits,,299.85,,Online banking Deposit - Remote deposit
,4/17/2022,,Debit,-14.73,,37746816,Online banking Withdrawal Transfer to LXX00 - Credit Card,Credit Card Payments,Transfer,0,,Online banking Withdrawal Transfer to L0100 - Credit Card Payment
,4/16/2022,,Debit,-26.85,,37711700,KING ZAH'S PIZZERIA 5814 LAS CRUCES NM,Restaurants & Dining,Debit Card,14.73,,Debit Card purchase KING ZAH'S PIZZERIA 5814 LAS CRUCES NM
,4/15/2022,,Debit,-12.65,,37711699,Sonic Drive-In,Restaurants & Dining,Debit Card,41.58,,Debit Card purchase SONIC DRIVE IN #3893 5814 LAS CRUCES NM
,4/14/2022,,Debit,-11.47,,37596904,Whataburger,Restaurants & Dining,Debit Card,54.23,,Debit Card purchase WHATABURGER 465 5814 LAS CRUCES NM
,4/13/2022,,Debit,-7.53,,37548088,NMSU BOOKSTORE #XX 5942 LAS CRUCES NM,Hobbies,Debit Card,65.7,,Debit Card purchase NMSU BOOKSTORE #2218 5942 LAS CRUCES NM
,4/13/2022,,Debit,-10.88,,37548087,Amazon Digital Services,Entertainment,Debit Card,73.23,,Debit Card purchase PRIME VIDEO*1A12F4R61 5818 888-802-3080 WA
,4/13/2022,,Debit,-19.33,,37548086,MCW#x390-RINCONADA 7542 LAS CRUCES NM,Other Expenses,Debit Card,84.11,,Debit Card purchase MCW#1390-RINCONADA 7542 LAS CRUCES NM
,4/12/2022,,Debit,-145.12,,37489910,Walmart,Shopping,Debit Card,103.44,,Debit Card purchase WAL-MART #0806 5411 LAS CRUCES NM
,4/11/2022,,Debit,-10.6,,37489911,Wendy's,Restaurants & Dining,Debit Card,248.56,,POS Card purchase WENDY'S 8028 5814 565 WALTON BLVD LAS CRUCES NM
,4/11/2022,,Debit,-100,,37422318,Online banking Withdrawal Transfer to LXX00 - Credit Card,Credit Card Payments,Transfer,259.16,,Online banking Withdrawal Transfer to L0100 - Credit Card Payment
,4/11/2022,,Credit,351.08,,37412828,Online banking Deposit - Remote deposit,Deposits,,359.16,,Online banking Deposit - Remote deposit
,3/30/2022,,Debit,-1.15,,36809660,MESILLA VALLEY VEND 5814 LAS CRUCES NM,Groceries,Debit Card,8.08,,Debit Card purchase MESILLA VALLEY VEND 5814 LAS CRUCES NM
,3/29/2022,,Debit,-2.35,,36809659,Pepsi Vending Machines,Groceries,Debit Card,9.23,,Debit Card purchase 2575PEPSIVEN9147678600 5814 LAS CRUCES NM
,3/29/2022,,Debit,-3.74,,36809658,Starbucks,Restaurants & Dining,Debit Card,11.58,,Debit Card purchase STARBUCKS STORE 11645 5814 LAS CRUCES NM
,3/28/2022,,Debit,-300,,36688793,Online banking Withdrawal Transfer to LXX00 - Credit Card,Credit Card Payments,Transfer,15.32,,Online banking Withdrawal Transfer to L0100 - Credit Card Payment
,3/28/2022,,Credit,314.53,,36678072,Online banking Deposit - Remote deposit,Deposits,,315.32,,Online banking Deposit - Remote deposit
,3/24/2022,,Debit,-9.36,,36478320,CCSU FOOD CT 5814 LAS CRUCES NM,Groceries,Debit Card,0.79,,Debit Card purchase CCSU FOOD CT 5814 LAS CRUCES NM
,3/24/2022,,Debit,-11.21,,36478319,SQ *KEVA UNIVERSITY IN LC 5812 LAS CRUCES NM,Education,Debit Card,10.15,,Debit Card purchase SQ *KEVA UNIVERSITY IN LC 5812 LAS CRUCES NM
,3/23/2022,,Debit,-400,,36465442,Online banking Withdrawal Transfer to LXX00 - Credit Card,Credit Card Payments,Transfer,21.36,,Online banking Withdrawal Transfer to L0100 - Credit Card Payment
,3/23/2022,,Debit,-1.8,,36465397,CCSU FOOD CT 5814 LAS CRUCES NM,Groceries,Debit Card,421.36,,Debit Card purchase CCSU FOOD CT 5814 LAS CRUCES NM
,3/23/2022,,Debit,-2.66,,36465396,Einstein Bros. Bagels,Restaurants & Dining,Debit Card,423.16,,Debit Card purchase EINSTEINS CCSU 5814 LAS CRUCES NM
,3/22/2022,,Debit,-20,,36465395,ATM Withdrawal FIRSTLIGHT XX 2795 SOUTH LOCUST ST LAS CRUCES NM,ATM/Cash Withdrawals,Debit Card,425.82,,ATM Withdrawal FIRSTLIGHT 6011 2795 SOUTH LOCUST ST LAS CRUCES NM
,3/22/2022,,Debit,-54.09,,36465394,Walmart,Shopping,Debit Card,445.82,,POS Card purchase WM SUPERCENTER # 5411 WAL-MART SUPER CENTER LAS CRUCES NM
,3/21/2022,,Debit,-9.41,,36355515,Whataburger,Restaurants & Dining,Debit Card,499.91,,Debit Card purchase WHATABURGER 465 5814 LAS CRUCES NM
,3/20/2022,,Debit,-57.38,,36355514,Staples,Office Supplies,Debit Card,509.32,,Debit Card purchase STAPLES 00113753 5943 LAS CRUCES NM
,3/20/2022,,Debit,-26.25,,36355513,Supercuts,Personal Care & Fitness,Debit Card,566.7,,Debit Card purchase SUPERCUTS LAS CRUCES II 7230 LAS CRUCES NM
,3/19/2022,,Debit,-51.68,,36285684,The Home Depot,Home Supplies,Debit Card,592.95,,POS Card purchase THE HOME DEPOT #3505 5200 225 TELSHORE BLVD LAS CRUCES NM
,3/19/2022,,Debit,-4.29,,36280134,Lowe's,Home Supplies,Debit Card,644.63,,Debit Card purchase LOWES #01158* 5200 LAS CRUCES NM
,3/18/2022,,Debit,-18.15,,36248906,Walmart,Shopping,Debit Card,648.92,,POS Card purchase WM SUPERCENTER # 5411 WAL-MART SUPER CENTER LAS CRUCES NM
,3/18/2022,,Debit,-10.6,,36248907,Wendy's,Restaurants & Dining,Debit Card,667.07,,POS Card purchase WENDY'S 8028 5814 565 WALTON BLVD LAS CRUCES NM
,3/18/2022,,Credit,100,,36240221,Cash Deposit,Deposits,Deposit,677.67,,Cash Deposit
,3/17/2022,,Debit,-100,,36187753,Online banking Withdrawal Transfer to LXX00 - Credit Card,Credit Card Payments,Transfer,577.67,,Online banking Withdrawal Transfer to L0100 - Credit Card Payment
,3/17/2022,,Credit,177.67,,36148165,Online banking Deposit - Remote deposit,Deposits,,677.67,,Online banking Deposit - Remote deposit
,3/13/2022,,Debit,-19.33,,36028515,MCW#x390-RINCONADA 7542 LAS CRUCES NM,Other Expenses,Debit Card,500,,Debit Card purchase MCW#1390-RINCONADA 7542 LAS CRUCES NM
,3/13/2022,,Debit,-11.1,,36028514,Chick-fil-A,Restaurants & Dining,Debit Card,519.33,,Debit Card purchase CHICK-FIL-A #03693 5814 LAS CRUCES NM
,3/13/2022,,Debit,-3.74,,35910512,Starbucks,Restaurants & Dining,Debit Card,530.43,,Debit Card purchase STARBUCKS STORE 11645 5814 LAS CRUCES NM
,3/13/2022,,Debit,-6.53,,35910511,Amazon Digital Services,Entertainment,Debit Card,534.17,,Debit Card purchase AMAZON DIGIT*1Z28H3281 5818 AMZN.COM/BILL WA
,3/13/2022,,Debit,-10.88,,35910514,Amazon Digital Services,Entertainment,Debit Card,540.7,,Debit Card purchase PRIME VIDEO*1Z6RN1XI0 5818 888-802-3080 WA
,3/12/2022,,Debit,-199.38,,35910513,Best Buy,Electronics & Equipment,Debit Card,551.58,,POS Card purchase BEST BUY 00008029 5732 2280 E. LOHMMAN AV LAS CRUCES NM
,3/12/2022,,Debit,-500,,35892391,Online banking Withdrawal Transfer to LXX00 - Credit Card,Credit Card Payments,Transfer,750.96,,Online banking Withdrawal Transfer to L0100 - Credit Card Payment
,3/12/2022,,Debit,-3.76,,35892308,Starbucks,Restaurants & Dining,Debit Card,1250.96,,Debit Card purchase STARBUCKS STORE 50626 5814 ESPANOLA NM
,3/12/2022,,Debit,-5.75,,35892315,Dreamcatcher,Gifts,Debit Card,1254.72,,Debit Card purchase DREAMCATCHER 10 7832 ESPANOLA NM
,3/12/2022,,Debit,-12,,35892307,Panda Express,Restaurants & Dining,Debit Card,1260.47,,Debit Card purchase PANDA EXPRESS 862 5814 SANTA FE NM
,3/11/2022,,Debit,-20.85,,35892314,Card NAMBE FALLS TRAVEL CENTE XX7730 US XX-285 SANTA FE NM,Travel & Commute,Debit Card,1272.47,,POS Card purchase NAMBE FALLS TRAVEL CENTE 5542 17730 US 84-285 SANTA FE NM
,3/11/2022,,Debit,-8.58,,35892306,Walmart,Shopping,Debit Card,1293.32,,POS Card purchase WM SUPERCENTER # 5411 WAL-MART SUPER CENTER ESPANOLA NM
,3/11/2022,,Credit,1100,,35892313,Cash and check Deposit,Deposits,,1301.9,,Cash and check Deposit
,3/9/2022,,Debit,-33.36,,35892312,Phillips 66,Gasoline/Fuel,Debit Card,201.9,,Debit Card purchase PHILLIPS 66 - YOUNG BACAS 5542 BELEN NM
,3/9/2022,,Debit,-4.03,,35892311,Marathon Petroleum,Gasoline/Fuel,Debit Card,235.26,,Debit Card purchase MARATHON PETRO235069 5541 LEMITAR NM
,3/9/2022,,Debit,-46.17,,35892310,Circle K,Groceries,Debit Card,239.29,,Debit Card purchase CIRCLE K # 41289 5542 LAS CRUCES NM
,3/8/2022,,Debit,-6.49,,35892305,Sonic Drive-In,Restaurants & Dining,Debit Card,285.46,,Debit Card purchase SONIC DRIVE IN #3893 5814 LAS CRUCES NM
,3/8/2022,,Debit,-16.66,,35892309,Wendy's,Restaurants & Dining,Debit Card,291.95,,POS Card purchase WENDY'S 8028 5814 565 WALTON BLVD LAS CRUCES NM
,3/8/2022,,Debit,-20.28,,35665237,IHOP,Restaurants & Dining,Debit Card,308.61,,Debit Card purchase IHOP #3428 5812 LAS CRUCES NM
,3/8/2022,,Credit,200,,35665239,Cash Deposit,Deposits,Deposit,328.89,,Cash Deposit
,3/8/2022,,Debit,-6.23,,35665236,Starbucks,Restaurants & Dining,Debit Card,128.89,,Debit Card purchase STARBUCKS STORE 11645 5814 LAS CRUCES NM
,3/8/2022,,Debit,-10.84,,35665235,McDonald's,Restaurants & Dining,Debit Card,135.12,,Debit Card purchase MCDONALD'S F20533 5814 LAS CRUCES NM
,3/7/2022,,Debit,-5.69,,35665234,Starbucks,Restaurants & Dining,Debit Card,145.96,,Debit Card purchase STARBUCKS STORE 02774 5814 LAS CRUCES NM
,3/7/2022,,Debit,-13.06,,35665238,Amazon,Shopping,,151.65,,Bill payment Withdrawal AMAZON.COM*1W5CT8J92 4816 SEATTLE WA
,3/6/2022,,Debit,-17.42,,35531726,Whataburger,Restaurants & Dining,Debit Card,164.71,,Debit Card purchase WHATABURGER 465 5814 LAS CRUCES NM
,3/5/2022,,Debit,-3.74,,35531725,Starbucks,Restaurants & Dining,Debit Card,182.13,,Debit Card purchase STARBUCKS STORE 10747 5814 LAS CRUCES NM
,3/4/2022,,Debit,-9.2,,35531724,Sonic Drive-In,Restaurants & Dining,Debit Card,185.87,,Debit Card purchase SONIC DRIVE IN #3893 5814 LAS CRUCES NM
,3/3/2022,,Debit,-100,,35392847,Online banking Withdrawal Transfer to LXX00 - .,Transfers,Transfer,195.07,,Online banking Withdrawal Transfer to L0100 - .
,3/3/2022,,Credit,300,,35392710,Check Deposit,Deposits,Deposit,295.07,,Check Deposit
,2/22/2022,,Debit,-14.15,,35021770,Payment to Amazon Prime,Dues and Subscriptions,,-4.93,,Bill payment Withdrawal AMAZON PRIME*TZ63E7053 5968 AMZN.COM/BILL WA
,2/22/2022,,Credit,0.06,,35021769,Deposit Transfer from SXX00 - Overdraft Transfer,Deposits,Transfer,9.22,,Deposit Transfer from S0000 - Overdraft Transfer
,2/20/2022,,Debit,-42.5,,35021782,PARKING & ID SERVICES XX4835 NM,Travel & Commute,Debit Card,9.16,,Debit Card purchase PARKING & ID SERVICES 8220 5756464835 NM
,2/19/2022,,Debit,-33.16,,35021768,Walmart,Shopping,Debit Card,51.66,,POS Card purchase WAL-MART #0806 5411 571 WALTON BLVD LAS CRUCES NM
,2/19/2022,,Debit,-2.98,,35021767,Starbucks,Restaurants & Dining,Debit Card,84.82,,Debit Card purchase STARBUCKS STORE 11645 5814 LAS CRUCES NM
,2/19/2022,,Debit,-23.22,,35021766,Domino's Pizza,Restaurants & Dining,Debit Card,87.8,,Debit Card purchase DOMINO'S 6501 5814 LAS CRUCES NM
,2/18/2022,,Debit,-55.1,,35021781,Amazon,Shopping,,111.02,,Bill payment Withdrawal AMAZON.COM*LS7T40JZ3 4816 SEATTLE WA
,2/18/2022,,Debit,-300,,35021765,Online banking Withdrawal Transfer to LXX00 - Internet Access 02/18/2022 16:24 XX7425:,Transfers,Transfer,166.12,,Online banking Withdrawal Transfer to L0100 - Internet Access 02/18/2022 16:24 337425:
,2/18/2022,,Debit,-19.72,,35021780,CCSU FOOD CT 5814 LAS CRUCES NM,Groceries,Debit Card,466.12,,Debit Card purchase CCSU FOOD CT 5814 LAS CRUCES NM
,2/18/2022,,Debit,-2.98,,35021779,NMSU ZUHL FUEL 5814 LAS CRUCES NM,Gasoline/Fuel,Debit Card,485.84,,Debit Card purchase NMSU ZUHL FUEL 5814 LAS CRUCES NM
,2/18/2022,,Debit,-7.89,,35021778,Einstein Bros. Bagels,Restaurants & Dining,Debit Card,488.82,,Debit Card purchase EINSTEINS CCSU 5814 LAS CRUCES NM
,2/17/2022,,Debit,-10.7,,35021777,Arby's,Restaurants & Dining,Debit Card,496.71,,Debit Card purchase ARBYS 6818 5812 LAS CRUCES NM
,2/16/2022,,Credit,500,,35021776,Check Deposit,Deposits,Deposit,507.41,,Check Deposit
,2/16/2022,,Debit,-42.48,,35021775,Circle K,Groceries,Debit Card,7.41,,Debit Card purchase CIRCLE K # 09665 5542 LAS CRUCES NM
,2/16/2022,,Debit,-16.77,,35021774,Wendy's,Restaurants & Dining,Debit Card,49.89,,POS Card purchase WENDY'S 8028 5814 565 WALTON BLVD LAS CRUCES NM
,2/15/2022,,Debit,-15.65,,35021773,CCSU FOOD CT 5814 LAS CRUCES NM,Groceries,Debit Card,66.66,,Debit Card purchase CCSU FOOD CT 5814 LAS CRUCES NM
,2/15/2022,,Debit,-10.29,,35021764,Panda Express,Restaurants & Dining,Debit Card,82.31,,Debit Card purchase PANDA EXPRESS #2206 5814 LAS CRUCES NM
,2/13/2022,,Debit,-16.09,,35021763,McDonald's,Restaurants & Dining,Debit Card,92.6,,Debit Card purchase MCDONALD'S F20533 5814 LAS CRUCES NM
,2/13/2022,,Debit,-6.53,,35021762,Amazon Digital Services,Entertainment,Debit Card,108.69,,Debit Card purchase AMAZON DIGIT*3O5G13QJ3 5818 AMZN.COM/BILL WA
,2/13/2022,,Debit,-10.88,,35021772,Amazon Digital Services,Entertainment,Debit Card,115.22,,Debit Card purchase PRIME VIDEO*5K22F5NK3 5818 888-802-3080 WA
,2/12/2022,,Debit,-13.21,,35021771,CCSU FOOD CT 5814 LAS CRUCES NM,Groceries,Debit Card,126.1,,Debit Card purchase CCSU FOOD CT 5814 LAS CRUCES NM
,2/9/2022,,Debit,-2.98,,33991314,NMSU ZUHL FUEL 5814 LAS CRUCES NM,Gasoline/Fuel,Debit Card,139.31,,Debit Card purchase NMSU ZUHL FUEL 5814 LAS CRUCES NM
,2/8/2022,,Credit,120,,33991313,Cash Deposit,Deposits,Deposit,142.29,,Cash Deposit
,1/28/2022,,Debit,-0.7,,33991308,Sonic Drive-In,Restaurants & Dining,Debit Card,22.29,,Debit Card purchase SONIC DRIVE IN #3893 5814 LAS CRUCES NM
,1/27/2022,,Debit,-24,,33991307,Online banking Withdrawal Transfer to LXX00 - Internet Access 01/27/2022 18:42 XX9692:,Transfers,Transfer,22.99,,Online banking Withdrawal Transfer to L0100 - Internet Access 01/27/2022 18:42 229692:
,1/26/2022,,Debit,-2.12,,33991312,NMSU ZUHL FUEL 5814 LAS CRUCES NM,Gasoline/Fuel,Debit Card,46.99,,Debit Card purchase NMSU ZUHL FUEL 5814 LAS CRUCES NM
,1/26/2022,,Debit,-12.02,,33991306,Panda Express,Restaurants & Dining,Debit Card,49.11,,Debit Card purchase PANDA EXPRESS #2206 5814 LAS CRUCES NM
,1/25/2022,,Debit,-10.55,,33991311,Einstein Bros. Bagels,Restaurants & Dining,Debit Card,61.13,,Debit Card purchase EINSTEINS CCSU 5814 LAS CRUCES NM
,1/22/2022,,Debit,-14.15,,33991305,Amazon,Shopping,,71.68,,Bill payment Withdrawal AMAZON PRIME*QG6W58L83 5968 AMZN.COM/BILL WA
,1/22/2022,,Debit,-17.23,,33991304,McDonald's,Restaurants & Dining,Debit Card,85.83,,Debit Card purchase MCDONALD'S F20533 5814 LAS CRUCES NM
,1/21/2022,,Debit,-180,,33991303,Online banking Withdrawal Transfer to LXX00 - Internet Access 01/21/2022 18:11 XX2892:,Transfers,Transfer,103.06,,Online banking Withdrawal Transfer to L0100 - Internet Access 01/21/2022 18:11 202892:
,1/21/2022,,Credit,256.5,,33991310,Check Deposit,Deposits,Deposit,283.06,,Check Deposit
,1/19/2022,,Debit,-2.44,,33991309,NMSU ZUHL FUEL 5814 LAS CRUCES NM,Gasoline/Fuel,Debit Card,26.56,,Debit Card purchase NMSU ZUHL FUEL 5814 LAS CRUCES NM
,1/15/2022,,Debit,-8.28,,33991302,Walmart,Shopping,Debit Card,29,,POS Card purchase WM SUPERCENTER # 5411 WAL-MART SUPER CENTER LAS CRUCES NM
,1/15/2022,,Debit,-2.98,,33991301,Starbucks,Restaurants & Dining,Debit Card,37.28,,Debit Card purchase STARBUCKS STORE 11645 5814 LAS CRUCES NM
,1/15/2022,,Debit,-42.1,,33991300,Payment to El Paso Electric,Utilities,Debit Card,40.26,,Debit Card purchase B2P*EL PASO ELECTRIC 9399 904-421-7220 TX
,1/14/2022,,Debit,-100,,33991241,Online banking Withdrawal Transfer to LXX00 - Internet Access 01/14/2022 18:49 XX1204:,Transfers,Transfer,82.36,,Online banking Withdrawal Transfer to L0100 - Internet Access 01/14/2022 18:49 171204:
,1/14/2022,,Debit,-13.65,,33991240,Panda Express,Restaurants & Dining,Debit Card,182.36,,Debit Card purchase PANDA EXPRESS #2206 5814 LAS CRUCES NM
,1/14/2022,,Debit,-10.17,,33991299,Wendy's,Restaurants & Dining,Debit Card,196.01,,POS Card purchase WENDY'S 8028 5814 565 WALTON BLVD LAS CRUCES NM
,1/13/2022,,Debit,-11.5,,33991298,CCSU FOOD CT 5814 LAS CRUCES NM,Groceries,Debit Card,206.18,,Debit Card purchase CCSU FOOD CT 5814 LAS CRUCES NM
,1/13/2022,,Debit,-3.41,,33991297,Einstein Bros. Bagels,Restaurants & Dining,Debit Card,217.68,,Debit Card purchase EINSTEINS CCSU 5814 LAS CRUCES NM
,1/13/2022,,Debit,-6.53,,33991239,Amazon Digital Services,Entertainment,Debit Card,221.09,,Debit Card purchase AMAZON DIGIT*0L8NG1733 5818 AMZN.COM/BILL WA
,1/13/2022,,Debit,-10.88,,33991296,Amazon Digital Services,Entertainment,Debit Card,227.62,,Debit Card purchase PRIME VIDEO*529W30V63 5818 888-802-3080 WA
,1/12/2022,,Debit,-11.34,,33991238,Lowe's,Home Supplies,Debit Card,238.5,,Debit Card purchase LOWE'S #58 5411 LAS CRUCES NM
,1/11/2022,,Debit,-105.01,,33991295,OUTDOOR ADVENTURES 5940 LAS CRUCES NM,Entertainment,Debit Card,249.84,,Debit Card purchase OUTDOOR ADVENTURES 5940 LAS CRUCES NM
,1/11/2022,,Debit,-36.83,,33991237,Walmart,Shopping,Debit Card,354.85,,POS Card purchase WM SUPERCENTER # 5411 WAL-MART SUPER CENTER LAS CRUCES NM
,1/8/2022,,Debit,-9.14,,33991236,Sonic Drive-In,Restaurants & Dining,Debit Card,391.68,,Debit Card purchase SONIC DRIVE IN #1982 5814 ESPANOLA NM
,1/8/2022,,Debit,-3.25,,33991294,Lowe's,Home Supplies,Debit Card,400.82,,Debit Card purchase LOWES #02510* 5200 ESPANOLA NM
,1/7/2022,,Debit,-995.72,,33991235,Online banking Withdrawal Transfer to LXX00 - Internet Access 01/07/2022 17:18 XX7084:,Transfers,Transfer,404.07,,Online banking Withdrawal Transfer to L0100 - Internet Access 01/07/2022 17:18 137084:
,1/7/2022,,Debit,-144.88,,33991293,HACIENDA HOME CENTERS - E XX8811 NM,Home Supplies,Debit Card,1399.79,,Debit Card purchase HACIENDA HOME CENTERS - E 5039 505-8848811 NM
,1/7/2022,,Debit,-20.24,,33991292,Lowe's,Home Supplies,Debit Card,1544.67,,Debit Card purchase LOWES #02510* 5200 ESPANOLA NM
,1/7/2022,,Debit,-30.15,,33991291,Speedway,Gasoline/Fuel,Debit Card,1564.91,,Debit Card purchase SPEEDWAY 09135 1313 PASEO 5542 ESPANOLA NM
,1/6/2022,,Debit,-5.86,,33991234,Subway,Restaurants & Dining,Debit Card,1595.06,,Debit Card purchase SUBWAY 54052 5814 ESPANOLA NM
,1/5/2022,,Credit,1600,,33991290,Check Deposit,Deposits,Deposit,1600.92,,Check Deposit
,1/5/2022,,Debit,-430,,33991289,HACIENDA HOME CENTERS - E XX8811 NM,Home Supplies,Debit Card,0.92,,Debit Card purchase HACIENDA HOME CENTERS - E 5039 505-8848811 NM
,1/4/2022,,Credit,394,,33991288,Transfer from Venmo,Transfers,,430.92,,Debit Deposit VENMO*MALCOM ISAIAH 4829 NEW YORK CITY NY
,12/28/2021,,Debit,-6.86,,33991233,McDonald's,Restaurants & Dining,Debit Card,36.92,,POS Card purchase MCDONALD'S F36782 5814 1401 N RIVERSIDE DR ESPANOLA NM
,12/26/2021,,Debit,-3.24,,33991232,Walmart,Shopping,Debit Card,43.78,,POS Card purchase WAL-MART #2656 5411 1610 NO. RIVERSIDE DRIV ESPANOLA NM
,12/24/2021,,Debit,-1.08,,33991287,HACIENDA HOME CENTERS - E XX8811 NM,Home Supplies,Debit Card,47.02,,Debit Card purchase HACIENDA HOME CENTERS - E 5039 505-8848811 NM
,12/21/2021,,Debit,-6.66,,33991231,Walmart,Shopping,Debit Card,48.1,,POS Card purchase WM SUPERCENTER # 5411 WAL-MART SUPER CENTER ESPANOLA NM
,12/21/2021,,Debit,-144.88,,33991286,HACIENDA HOME CENTERS - E XX8811 NM,Home Supplies,Debit Card,54.76,,Debit Card purchase HACIENDA HOME CENTERS - E 5039 505-8848811 NM
,12/21/2021,,Debit,-347.89,,33991285,HACIENDA HOME CENTERS - E XX8811 NM,Home Supplies,Debit Card,199.64,,Debit Card purchase HACIENDA HOME CENTERS - E 5039 505-8848811 NM
,12/20/2021,,Credit,492.5,,33991284,Transfer from Venmo,Transfers,,547.53,,Debit Deposit VENMO*MALCOM ISAIAH 4829 NEW YORK CITY NY
,12/19/2021,,Debit,-100,,33991230,Online banking Withdrawal Transfer to LXX00 - Internet Access 12/19/2021 10:46 x8424:,Transfers,Transfer,55.03,,Online banking Withdrawal Transfer to L0100 - Internet Access 12/19/2021 10:46 48424:
,12/16/2021,,Debit,-240,,33991229,Transfer to Venmo,Transfers,Debit Card,155.03,,Debit Card purchase VENMO* 4829 VISA DIRECT NY
,12/16/2021,,Debit,-10,,33991228,Transfer to Venmo,Transfers,Debit Card,395.03,,Debit Card purchase VENMO* 4829 VISA DIRECT NY
,12/16/2021,,Credit,320,,33991283,Cash and check Deposit,Deposits,,405.03,,Cash and check Deposit
,12/13/2021,,Debit,-16.23,,33991282,Albertsons,Groceries,Debit Card,85.03,,Debit Card purchase ALBERTSONS #3913 5411 LAS CRUCES NM
,12/12/2021,,Credit,54.34,,33991281,Walmart,Shopping,Debit Card,101.26,,Debit Card purchase return Adjustment WM SUPERCENTER #2656 5411 ESPANOLA NM
,12/11/2021,,Debit,-9.65,,33991227,Panda Express,Restaurants & Dining,Debit Card,46.92,,Debit Card purchase PANDA EXPRESS 862 5814 SANTA FE NM
,12/10/2021,,Debit,-7.12,,33991280,XENOWARE XX3879 NY,Clothing,Debit Card,56.57,,Debit Card purchase XENOWARE 7311 844-6593879 NY
,12/7/2021,,Debit,-250,,33991226,Online banking Withdrawal Transfer to LXX00 - Internet Access 12/07/2021 10:07 XX8199:,Transfers,Transfer,63.69,,Online banking Withdrawal Transfer to L0100 - Internet Access 12/07/2021 10:07 988199:
,12/6/2021,,Debit,-54.34,,33991225,Walmart,Shopping,Debit Card,313.69,,POS Card purchase WM SUPERCENTER # 5411 WAL-MART SUPER CENTER ESPANOLA NM
,12/6/2021,,Debit,-9.68,,33991224,McDonald's,Restaurants & Dining,Debit Card,368.03,,POS Card purchase MCDONALD'S F36782 5814 1401 N RIVERSIDE DR ESPANOLA NM
,12/6/2021,,Debit,-400,,33991223,Online banking Withdrawal Transfer to LXX00 - Internet Access 12/06/2021 10:23 XX3807:,Transfers,Transfer,377.71,,Online banking Withdrawal Transfer to L0100 - Internet Access 12/06/2021 10:23 983807:
,12/6/2021,,Credit,757.5,,33991279,Check Deposit,Deposits,Deposit,777.71,,Check Deposit
,11/11/2021,,Debit,-5,,33991278,NAYAX WASH 7542 HUNT VALLEY MD,Automotive Expenses,Debit Card,20.21,,Debit Card purchase NAYAX WASH 7542 HUNT VALLEY MD
,11/10/2021,,Debit,-30,,33991222,Online banking Withdrawal Transfer to LXX00 - Internet Access 11/10/2021 14:02 XX9031:,Transfers,Transfer,25.21,,Online banking Withdrawal Transfer to L0100 - Internet Access 11/10/2021 14:02 859031:
,11/10/2021,,Debit,-15.08,,33991221,Walmart,Shopping,Debit Card,55.21,,POS Card purchase WM SUPERCENTER # 5411 WAL-MART SUPER CENTER ESPANOLA NM
,11/10/2021,,Credit,65,,33991277,ATM Deposit CU ANYTIME XX 1907 N. RIVERSIDE DR ESPANOLA NM,Deposits,,70.29,,ATM Deposit CU ANYTIME 6011 1907 N. RIVERSIDE DR ESPANOLA NM
,10/24/2021,,Debit,-69.3,,33991276,PIZZA 9 ESPANOLA 5812 ESPANOLA NM,Restaurants & Dining,Debit Card,5.29,,Debit Card purchase PIZZA 9 ESPANOLA 5812 ESPANOLA NM
,10/23/2021,,Credit,68.95,,33991275,Transfer from Venmo,Transfers,,74.59,,Debit Deposit VENMO*MALCOM ISAIAH 4829 NEW YORK CITY NY
,10/22/2021,,Debit,-8.05,,33991220,McDonald's,Restaurants & Dining,Debit Card,5.64,,POS Card purchase MCDONALD'S F36782 5814 1401 N RIVERSIDE DR ESPANOLA NM
,10/19/2021,,Debit,-10.67,,33991219,YouTube Music,Entertainment,Debit Card,13.69,,Debit Card purchase GOOGLE *YOUTUBE MUSIC 5817 G.CO/HELPPAY# CA
,10/18/2021,,Debit,-14.03,,33991218,Sonic Drive-In,Restaurants & Dining,Debit Card,24.36,,Debit Card purchase SONIC DRIVE IN #1962 5814 ESPANOLA NM
,10/17/2021,,Debit,-7.99,,33991274,Mojang,Entertainment,Debit Card,38.39,,Debit Card purchase MOJANG 5816 STOCKHOLM SE
,10/17/2021,,Debit,-7.99,,33991273,Mojang,Entertainment,Debit Card,46.38,,Debit Card purchase MOJANG 5816 STOCKHOLM SE
,10/17/2021,,Debit,-2,,33991272,USA*CSC TEP CO 5999 ESPANOLA NM,Travel & Commute,Debit Card,54.37,,Debit Card purchase USA*CSC TEP CO 5999 ESPANOLA NM
,10/17/2021,,Debit,-2,,33991271,USA*CSC TEP CO 5999 ESPANOLA NM,Travel & Commute,Debit Card,56.37,,Debit Card purchase USA*CSC TEP CO 5999 ESPANOLA NM
,10/13/2021,,Debit,-10.77,,33991217,McDonald's,Restaurants & Dining,Debit Card,58.37,,Debit Card purchase MCDONALD'S F36782 5814 ESPANOLA NM
,10/13/2021,,Debit,-6.53,,33991216,Amazon Digital Services,Entertainment,Debit Card,69.14,,Debit Card purchase AMAZON DIGIT*279EG4PV2 5818 AMZN.COM/BILL WA
,10/12/2021,,Credit,20,,33991270,ACH Deposit COMPANY: VENMO ENTRY: CASHOUT ISAIAH MALCOM,Transfers,ACH,75.67,,ACH Deposit COMPANY: VENMO ENTRY: CASHOUT ISAIAH MALCOM
,10/10/2021,,Debit,-140,,33991215,Online banking Withdrawal Transfer to LXX00 - Internet Access 10/10/2021 10:13 XX1412:,Transfers,Transfer,55.67,,Online banking Withdrawal Transfer to L0100 - Internet Access 10/10/2021 10:13 711412:
,10/10/2021,,Debit,-114.35,,33991269,HACIENDA HOME CENTERS - E XX8811 NM,Home Supplies,Debit Card,195.67,,Debit Card purchase HACIENDA HOME CENTERS - E 5039 505-8848811 NM
,10/10/2021,,Debit,-42.07,,33991268,Speedway,Gasoline/Fuel,Debit Card,310.02,,POS Card purchase SPEEDWAY 5542 1225 PASEO DE ONATE ESPANOLA NM
,10/10/2021,,Credit,230,,33991267,Anytime Fitness Deposit,Deposits,,352.09,,ATM Deposit CU ANYTIME 6011 1216 PASO DE ONATE ESPANOLA NM
,10/10/2021,,Debit,-5.01,,33991266,Blake's Lotaburger,Restaurants & Dining,Debit Card,122.09,,Debit Card purchase BLAKE S LOTABURGER - 020 5814 ESPANOLA NM
,10/9/2021,,Credit,3,,33991214,Online banking Deposit Transfer from SXX00 - Internet Access 10/09/2021 06:28 XX7927:,Deposits,Transfer,127.1,,Online banking Deposit Transfer from S0000 - Internet Access 10/09/2021 06:28 707927:
,10/8/2021,,Credit,108.35,,33991265,Transfer from Venmo,Transfers,,124.1,,Debit Deposit VENMO*MALCOM ISAIAH 4829 NEW YORK CITY NY
,10/4/2021,,Debit,-32.05,,33991264,Steam,Entertainment,Debit Card,15.75,,Debit Card purchase STEAM PURCHASE 5816 425-9522985 WA
,10/2/2021,,Debit,-0.2,,33991263,Withdrawal XENOWARE XX3879 NY,Clothing,,47.8,,Bill payment Withdrawal XENOWARE 7311 844-6593879 NY
,10/2/2021,,Debit,-8.7,,33991262,Disney Plus,Entertainment,Debit Card,48,,Debit Card purchase DISNEY PLUS 4899 BURBANK CA
,9/29/2021,,Debit,-60,,33991213,Online banking Withdrawal Transfer to LXX00 - Internet Access 09/29/2021 15:53 XX7860:,Transfers,Transfer,56.7,,Online banking Withdrawal Transfer to L0100 - Internet Access 09/29/2021 15:53 657860:
,9/29/2021,,Credit,113,,33991261,ACH Deposit COMPANY: VENMO ENTRY: CASHOUT ISAIAH MALCOM,Transfers,ACH,116.7,,ACH Deposit COMPANY: VENMO ENTRY: CASHOUT ISAIAH MALCOM
,9/23/2021,,Debit,-10.88,,33991260,Spotify,Entertainment,,3.7,,Bill payment Withdrawal SPOTIFY USA 4899 877-7781161 NY
,9/22/2021,,Debit,-14.15,,33991212,Amazon,Shopping,,14.58,,Bill payment Withdrawal AMAZON PRIME*2C5O09F71 5968 AMZN.COM/BILL WA
,9/21/2021,,Debit,-37.76,,33991259,Amazon,Shopping,Debit Card,28.73,,POS Card purchase AMAZON.COM*2G7PC0HC2 4816 SEATTLE WA
,9/19/2021,,Debit,-10.67,,33991258,YouTube Music,Online Services,Debit Card,66.49,,Debit Card purchase GOOGLE*YOUTUBE MUSIC 4899 SUPPORT.GOOGL CA
,9/17/2021,,Debit,-13.85,,33991257,El Parasol,Restaurants & Dining,Debit Card,77.16,,Debit Card purchase EL PARASOL 5812 ESPANOLA NM
,9/15/2021,,Debit,-25.76,,33991256,Amazon,Shopping,,91.01,,Bill payment Withdrawal AMAZON.COM*2G5KZ5LV2 4816 SEATTLE WA
,9/15/2021,,Debit,-6.53,,33991255,Amazon Marketplace,Shopping,Debit Card,116.77,,Debit Card purchase AMZN MKTP US*2G4DQ34Y2 5942 AMZN.COM/BILL WA
,9/15/2021,,Credit,30,,33991254,ACH Deposit COMPANY: VENMO ENTRY: CASHOUT ISAIAH MALCOM,Transfers,ACH,123.3,,ACH Deposit COMPANY: VENMO ENTRY: CASHOUT ISAIAH MALCOM
,9/15/2021,,Debit,-10.07,,33991253,Freddy's Frozen Custard & Steakburgers,Restaurants & Dining,Debit Card,93.3,,Debit Card purchase FREDDY'S 28-0005 5814 ESPANOLA NM
,9/14/2021,,Debit,-15.16,,33991211,Walmart,Shopping,Debit Card,103.37,,POS Card purchase WM SUPERCENTER # 5411 WAL-MART SUPER CENTER ESPANOLA NM
,9/13/2021,,Debit,-6.53,,33991210,Amazon Digital Services,Entertainment,Debit Card,118.53,,Debit Card purchase AMAZON DIGIT*253PB8UT2 5818 AMZN.COM/BILL WA
,9/7/2021,,Debit,-5.17,,33991209,Starbucks,Restaurants & Dining,Debit Card,125.06,,Debit Card purchase STARBUCKS STORE 50626 5814 ESPANOLA NM
,9/6/2021,,Debit,-17,,33991208,Walmart,Shopping,Debit Card,130.23,,POS Card purchase WAL-MART SUPER CENTER 5411 2656 WAL-SAMS ESPANOLA NM
,9/6/2021,,Credit,32.03,,33991252,ATM Deposit CU ANYTIME XX 1907 N. RIVERSIDE DR ESPANOLA NM,Deposits,,147.23,,ATM Deposit CU ANYTIME 6011 1907 N. RIVERSIDE DR ESPANOLA NM
,9/6/2021,,Debit,-17.3,,33991251,Amazon,Shopping,,115.2,,Bill payment Withdrawal AMAZON.COM*254W01WY0 4816 SEATTLE WA
,9/5/2021,,Debit,-100,,33991207,Online banking Withdrawal Transfer to LXX00 - Internet Access 09/05/2021 05:00 XX4260:,Transfers,Transfer,132.5,,Online banking Withdrawal Transfer to L0100 - Internet Access 09/05/2021 05:00 544260:
,9/3/2021,,Debit,-7.9,,33991206,Starbucks,Restaurants & Dining,Debit Card,232.5,,Debit Card purchase STARBUCKS STORE 50626 5814 ESPANOLA NM
,9/3/2021,,Credit,25,,33991250,ACH Deposit COMPANY: VENMO ENTRY: CASHOUT ISAIAH MALCOM,Transfers,ACH,240.4,,ACH Deposit COMPANY: VENMO ENTRY: CASHOUT ISAIAH MALCOM
,8/30/2021,,Debit,-930,,33991205,Online banking Withdrawal Transfer to LXX00 - Internet Access 08/30/2021 11:40 XX4422:,Transfers,Transfer,215.4,,Online banking Withdrawal Transfer to L0100 - Internet Access 08/30/2021 11:40 514422:
,8/28/2021,,Debit,-8.7,,33991249,Disney Plus,Entertainment,,1145.4,,Bill payment Withdrawal DISNEYPLUS 4899 888-9057888 CA
,8/27/2021,,Credit,1150,,33991248,ACH Deposit COMPANY: NORTHERN NEW MEX ENTRY: ACH PAYMEN ISAIAH J. MALCOM,Deposits,ACH,1154.1,,ACH Deposit COMPANY: NORTHERN NEW MEX ENTRY: ACH PAYMEN ISAIAH J. MALCOM
,8/26/2021,,Debit,-16.33,,33991204,Amazon Digital Services,Entertainment,Debit Card,4.1,,Debit Card purchase AMAZON DIGIT*2506B9ZK0 5818 AMZN.COM/BILL WA
,8/26/2021,,Debit,-10.88,,33991247,Spotify,Entertainment,,20.43,,Bill payment Withdrawal SPOTIFY USA 4899 877-7781161 NY
,8/26/2021,,Debit,-40,,33991203,Online banking Withdrawal Transfer to LXX00 - Internet Access 08/25/2021 23:48 XX4673:,Transfers,Transfer,31.31,,Online banking Withdrawal Transfer to L0100 - Internet Access 08/25/2021 23:48 494673:
,8/25/2021,,Debit,-35.6,,33991202,Walmart,Shopping,Debit Card,71.31,,POS Card purchase WAL-MART #2656 5411 1610 NO. RIVERSIDE DRIV ESPANOLA NM
,8/25/2021,,Credit,100,,33991246,ATM Deposit CU ANYTIME XX 1907 N. RIVERSIDE DR ESPANOLA NM,Deposits,,106.91,,ATM Deposit CU ANYTIME 6011 1907 N. RIVERSIDE DR ESPANOLA NM
,8/19/2021,,Debit,-10.67,,33991245,YouTube Music,Entertainment,Debit Card,6.91,,Debit Card purchase GOOGLE*YOUTUBE MUSIC 5815 650-2530000 CA
,8/19/2021,,Debit,-10.9,,33991244,Steamgames,Entertainment,Debit Card,17.58,,Debit Card purchase STEAMGAMES.COM 4259522985 5816 425-8899642 WA
,8/13/2021,,Debit,-6.53,,33991201,Amazon Digital Services,Entertainment,Debit Card,28.48,,Debit Card purchase AMAZON DIGIT*2P4AS57K2 5818 AMZN.COM/BILL WA
,8/13/2021,,Debit,-2,,33991243,Cashier,Education,Debit Card,35.01,,Debit Card purchase NNMC - CASHIER 8220 505-7475050 NM
,8/12/2021,,Debit,-37.43,,33991242,Great Clips,Personal Care & Fitness,Debit Card,37.01,,Debit Card purchase 0646 GREAT CLIPS AT ESPAN 7230 ESPANOLA NM
,8/11/2021,,Debit,-100,,33991137,Online banking Withdrawal Transfer to LXX00 - Internet Access 08/11/2021 18:06 XX6814:,Transfers,Transfer,74.44,,Online banking Withdrawal Transfer to L0100 - Internet Access 08/11/2021 18:06 426814:
,8/11/2021,,Credit,160,,33991200,Anytime Fitness Deposit,Deposits,,174.44,,ATM Deposit CU ANYTIME 6011 1216 PASO DE ONATE ESPANOLA NM
,8/11/2021,,Debit,-17.4,,33991199,Harbor Freight Tools,Home Supplies,Debit Card,14.44,,Debit Card purchase HARBOR FREIGHT TOOLS2986 5251 CALABASAS CA
,8/11/2021,,Debit,-10.61,,33991198,Freddy's Frozen Custard & Steakburgers,Restaurants & Dining,Debit Card,31.84,,Debit Card purchase FREDDY'S 28-0005 5814 ESPANOLA NM
,8/10/2021,,Credit,40,,33991197,ATM Deposit CU ANYTIME XX 1907 N. RIVERSIDE DR ESPANOLA NM,Deposits,,42.45,,ATM Deposit CU ANYTIME 6011 1907 N. RIVERSIDE DR ESPANOLA NM
,8/8/2021,,Debit,-48.17,,33991196,Speedway,Gasoline/Fuel,Debit Card,2.45,,Debit Card purchase SPEEDWAY 09135 1313 PASEO 5542 ESPANOLA NM
,8/5/2021,,Debit,-50,,33991136,Online banking Withdrawal Transfer to LXX00 - Internet Access 08/05/2021 15:55 XX0420:,Transfers,Transfer,50.62,,Online banking Withdrawal Transfer to L0100 - Internet Access 08/05/2021 15:55 400420:
,8/5/2021,,Debit,-6.85,,33991195,Blake's Lotaburger,Restaurants & Dining,Debit Card,100.62,,Debit Card purchase BLAKE S LOTABURGER - 020 5814 ESPANOLA NM
,8/5/2021,,Credit,40,,33991194,ACH Deposit COMPANY: VENMO ENTRY: CASHOUT ISAIAH MALCOM,Transfers,ACH,107.47,,ACH Deposit COMPANY: VENMO ENTRY: CASHOUT ISAIAH MALCOM
,8/4/2021,,Debit,-24.01,,33991193,Phillips 66,Gasoline/Fuel,Debit Card,67.47,,Debit Card purchase PHILLIPS 66 - MALHI C STO 5542 ESPANOLA NM
,8/4/2021,,Debit,-44.62,,33991192,Lowe's,Home Supplies,Debit Card,91.48,,Debit Card purchase LOWES #02510* 5200 ESPANOLA NM
,8/4/2021,,Credit,39.4,,33991191,Transfer from Venmo,Transfers,,136.1,,Debit Deposit VENMO*MALCOM ISAIAH 4829 NEW YORK CITY NY
,8/3/2021,,Credit,40,,33991190,ATM Deposit CU ANYTIME XX 1907 N. RIVERSIDE DR ESPANOLA NM,Deposits,,96.7,,ATM Deposit CU ANYTIME 6011 1907 N. RIVERSIDE DR ESPANOLA NM
,8/3/2021,,Credit,50,,33991189,ATM Deposit CU ANYTIME XX 1907 N. RIVERSIDE DR ESPANOLA NM,Deposits,,56.7,,ATM Deposit CU ANYTIME 6011 1907 N. RIVERSIDE DR ESPANOLA NM
,8/1/2021,,Debit,-10.5,,33991188,Spotify,Entertainment,,6.7,,Bill payment Withdrawal SPOTIFY USA 4899 877-7781161 NY
,7/31/2021,,Debit,-8.7,,33991187,Disney Plus,Entertainment,,17.2,,Bill payment Withdrawal DISNEYPLUS 4899 888-9057888 CA
,7/31/2021,,Debit,-32.67,,33991135,Amazon Digital Services,Entertainment,Debit Card,25.9,,Debit Card purchase AMAZON DIGIT*2P3PK03R0 5818 AMZN.COM/BILL WA
,7/31/2021,,Debit,-16.06,,33991186,Steamgames,Entertainment,Debit Card,58.57,,Debit Card purchase STEAMGAMES.COM 4259522985 5816 425-8899642 WA
,7/30/2021,,Debit,-125,,33991134,Online banking Withdrawal Transfer to LXX00 - Internet Access 07/29/2021 23:21 XX7083:,Transfers,Transfer,74.63,,Online banking Withdrawal Transfer to L0100 - Internet Access 07/29/2021 23:21 367083:
,7/30/2021,,Credit,198,,33991185,Transfer from Venmo,Transfers,,199.63,,Debit Deposit VENMO*MALCOM ISAIAH 4829 NEW YORK CITY NY
,7/22/2021,,Debit,-14.15,,33991133,Amazon,Shopping,,1.63,,Bill payment Withdrawal AMAZON PRIME*2E6N90PS2 5968 AMZN.COM/BILL WA
,7/21/2021,,Debit,-2.89,,33991184,Speedway,Gasoline/Fuel,Debit Card,15.78,,Debit Card purchase SPEEDWAY 09135 1313 PASEO 5541 ESPANOLA NM
,7/19/2021,,Debit,-5.94,,33991132,Starbucks,Restaurants & Dining,Debit Card,18.67,,Debit Card purchase STARBUCKS STORE 50626 5814 ESPANOLA NM
,7/19/2021,,Debit,-10.67,,33991131,YouTube Music,Entertainment,,24.61,,Bill payment Withdrawal GOOGLE *YOUTUBE MUSIC 5968 650-253-0000 CA
,7/14/2021,,Debit,-5.94,,33991130,Starbucks,Restaurants & Dining,Debit Card,35.28,,Debit Card purchase STARBUCKS STORE 50626 5814 ESPANOLA NM
,7/14/2021,,Debit,-2.14,,33991183,Lowe's,Home Supplies,Debit Card,41.22,,Debit Card purchase LOWES #02510* 5200 ESPANOLA NM
,7/13/2021,,Debit,-6.53,,33991129,Amazon Digital Services,Entertainment,Debit Card,43.36,,Debit Card purchase AMAZON DIGIT*290Q91I30 5818 AMZN.COM/BILL WA
,7/10/2021,,Debit,-32.67,,33991128,Amazon Digital Services,Entertainment,Debit Card,49.89,,Debit Card purchase AMAZON DIGIT*298HE65D2 5818 AMZN.COM/BILL WA
,7/9/2021,,Credit,80,,33991182,ATM Deposit CU ANYTIME XX 1907 N. RIVERSIDE DR ESPANOLA NM,Deposits,,82.56,,ATM Deposit CU ANYTIME 6011 1907 N. RIVERSIDE DR ESPANOLA NM
,7/9/2021,,Debit,-9.79,,33991181,Amazon Digital Services,Entertainment,Debit Card,2.56,,Debit Card purchase PRIME VIDEO*295VJ2Y81 5818 888-802-3080 WA
,7/8/2021,,Debit,-16.01,,33991127,Starbucks,Restaurants & Dining,Debit Card,12.35,,Debit Card purchase STARBUCKS STORE 50626 5814 ESPANOLA NM
,7/8/2021,,Debit,-34.56,,33991180,Speedway,Gasoline/Fuel,Debit Card,28.36,,Debit Card purchase SPEEDWAY 09261 1616 N. RI 5542 ESPANOLA NM
,7/8/2021,,Debit,-21.22,,33991179,Freddy's Frozen Custard & Steakburgers,Restaurants & Dining,Debit Card,62.92,,Debit Card purchase FREDDY'S 28-0005 5814 ESPANOLA NM
,7/6/2021,,Credit,50,,33991178,ACH Deposit COMPANY: VENMO ENTRY: CASHOUT ISAIAH MALCOM,Transfers,ACH,84.14,,ACH Deposit COMPANY: VENMO ENTRY: CASHOUT ISAIAH MALCOM
,7/4/2021,,Debit,-68.58,,33991177,Amazon,Shopping,,34.14,,Bill payment Withdrawal AMAZON.COM*297961070 4816 SEATTLE WA
,7/2/2021,,Credit,100,,33991176,ACH Deposit COMPANY: VENMO ENTRY: CASHOUT ISAIAH MALCOM,Transfers,ACH,102.72,,ACH Deposit COMPANY: VENMO ENTRY: CASHOUT ISAIAH MALCOM
,7/2/2021,,Debit,-0.2,,33991175,Withdrawal XENOWARE XX3879 NY,Clothing,,2.72,,Bill payment Withdrawal XENOWARE 7311 844-6593879 NY
,7/1/2021,,Debit,-5.34,,33991126,Youtube Premium,Entertainment,,2.92,,Bill payment Withdrawal GOOGLE *YOUTUBE MEMBER 5968 650-253-0000 CA
,7/1/2021,,Debit,-15.76,,33991125,Shell,Gasoline/Fuel,Debit Card,8.26,,Debit Card purchase SHELL OIL 53028770062 5542 ESPANOLA NM
,6/30/2021,,Debit,-43.62,,33991174,Petsense,Pets,Debit Card,24.02,,Debit Card purchase PETSENSE #7034 5599 ESPANOLA NM
,6/30/2021,,Debit,-99,,33991173,NMSU CASHNET XX-2046 NM,Clothing,Debit Card,67.64,,Debit Card purchase NMSU CASHNET 8220 575-646-2046 NM
,6/30/2021,,Debit,-20.77,,33991124,McDonald's,Restaurants & Dining,Debit Card,166.64,,Debit Card purchase MCDONALD'S F36782 5814 ESPANOLA NM
,6/29/2021,,Debit,-7.68,,33991123,Starbucks,Restaurants & Dining,Debit Card,187.41,,Debit Card purchase STARBUCKS STORE 50626 5814 ESPANOLA NM
,6/29/2021,,Debit,-12.29,,33991172,Lowe's,Home Supplies,Debit Card,195.09,,Debit Card purchase LOWES #02510* 5200 ESPANOLA NM
,6/29/2021,,Credit,120,,33991171,ATM Deposit CU ANYTIME XX 1907 N. RIVERSIDE DR ESPANOLA NM,Deposits,,207.38,,ATM Deposit CU ANYTIME 6011 1907 N. RIVERSIDE DR ESPANOLA NM
,6/28/2021,,Debit,-40,,33991122,Online banking Withdrawal Transfer to LXX00 - Internet Access 06/28/2021 14:58 XX2163:,Transfers,Transfer,87.38,,Online banking Withdrawal Transfer to L0100 - Internet Access 06/28/2021 14:58 212163:
,6/28/2021,,Debit,-8.7,,33991170,Disney Plus,Entertainment,,127.38,,Bill payment Withdrawal DISNEYPLUS 4899 888-9057888 CA
,6/28/2021,,Debit,-326,,33991121,Transfer to Venmo,Transfers,Debit Card,136.08,,Debit Card purchase VENMO* 4829 VISA DIRECT NY
,6/27/2021,,Debit,-13.37,,33991120,Sonic Drive-In,Restaurants & Dining,Debit Card,462.08,,Debit Card purchase SONIC DRIVE IN #1982 5814 ESPANOLA NM
,6/27/2021,,Debit,-15.76,,33991119,Amazon Digital Services,Entertainment,Debit Card,475.45,,Debit Card purchase AMAZON DIGIT*291CM3JN1 5818 AMZN.COM/BILL WA
,6/26/2021,,Debit,-28.37,,33991118,Walmart,Shopping,Debit Card,491.21,,POS Card purchase WM SUPERCENTER # 5411 WAL-MART SUPER CENTER ESPANOLA NM
,6/26/2021,,Credit,200,,33991169,ATM Deposit CU ANYTIME XX 1907 N. RIVERSIDE DR ESPANOLA NM,Deposits,,519.58,,ATM Deposit CU ANYTIME 6011 1907 N. RIVERSIDE DR ESPANOLA NM
,6/26/2021,,Debit,-15.24,,33991168,Netflix,Entertainment,,319.58,,Bill payment Withdrawal NETFLIX COM 4899 LOS GATOS CA
,6/26/2021,,Debit,-10.5,,33991167,Spotify,Entertainment,,334.82,,Bill payment Withdrawal SPOTIFY USA 4899 877-7781161 NY
,6/26/2021,,Credit,326.8,,33991166,Harbor Freight Tools,Home Supplies,Debit Card,345.32,,Debit Card purchase return Adjustment HARBOR FREIGHT TOOLS2986 5251 CALABASAS CA
,6/25/2021,,Debit,-21.36,,33991117,Google Play,Online Services,,18.52,,Bill payment Withdrawal GOOGLE *PLAY CHARGE 5968 650-253-0000 CA
,6/25/2021,,Debit,-4.36,,33991165,Dollar Tree,Shopping,Debit Card,39.88,,Debit Card purchase DOLLARTREE 5331 ESPANOLA NM
,6/24/2021,,Credit,43,,33991164,ATM Deposit CU ANYTIME XX 1907 N. RIVERSIDE DR ESPANOLA NM,Deposits,,44.24,,ATM Deposit CU ANYTIME 6011 1907 N. RIVERSIDE DR ESPANOLA NM
,6/19/2021,,Debit,-10.67,,33991116,YouTube Music,Entertainment,,1.24,,Bill payment Withdrawal GOOGLE *YOUTUBE MUSIC 5968 650-253-0000 CA
,6/16/2021,,Debit,-1.6,,33991163,Lowe's,Home Supplies,Debit Card,11.91,,Debit Card purchase LOWES #02510* 5200 ESPANOLA NM
,6/15/2021,,Debit,-17.23,,33991162,Amazon,Shopping,,13.51,,Bill payment Withdrawal AMAZON.COM*2X6S81RH0 5942 SEATTLE WA
,6/14/2021,,Debit,-13.34,,33991161,Lowe's,Home Supplies,Debit Card,30.74,,Debit Card purchase LOWES #02510* 5200 ESPANOLA NM
,6/14/2021,,Credit,20,,33991160,ACH Deposit COMPANY: VENMO ENTRY: CASHOUT ISAIAH MALCOM,Transfers,ACH,44.08,,ACH Deposit COMPANY: VENMO ENTRY: CASHOUT ISAIAH MALCOM
,6/13/2021,,Debit,-71.4,,33991159,Lowe's,Home Supplies,Debit Card,24.08,,Debit Card purchase LOWES #02510* 5200 ESPANOLA NM
,6/13/2021,,Debit,-6.3,,33991115,Amazon Digital Services,Entertainment,Debit Card,95.48,,Debit Card purchase AMAZON DIGIT*2155I4NN1 5818 AMZN.COM/BILL WA
,6/12/2021,,Credit,100,,33991158,ATM Deposit CU ANYTIME XX 1907 N. RIVERSIDE DR ESPANOLA NM,Deposits,,101.78,,ATM Deposit CU ANYTIME 6011 1907 N. RIVERSIDE DR ESPANOLA NM
,6/9/2021,,Debit,-7.6,,33991114,Walmart,Shopping,Debit Card,1.78,,POS Card purchase WAL-MART #2656 5411 1610 NO. RIVERSIDE DRIV ESPANOLA NM
,6/9/2021,,Debit,-9.45,,33991157,Amazon Digital Services,Entertainment,Debit Card,9.38,,Debit Card purchase PRIME VIDEO*2X2UT2KB1 5818 888-802-3080 WA
,6/9/2021,,Debit,-43.38,,33991156,AHH DENTAL PC 8021 SANTA FE NM,Healthcare & Pharmacy,Debit Card,18.83,,Debit Card purchase AHH DENTAL PC 8021 SANTA FE NM
,6/8/2021,,Debit,-3.76,,33991113,Starbucks,Restaurants & Dining,Debit Card,62.21,,Debit Card purchase STARBUCKS STORE 50626 5814 ESPANOLA NM
,6/7/2021,,Debit,-49.16,,33991112,Walmart,Shopping,Debit Card,65.97,,POS Card purchase WAL-MART #2656 5411 1610 NO. RIVERSIDE DRIV ESPANOLA NM
,6/7/2021,,Credit,100,,33991155,ATM Deposit CU ANYTIME XX 1907 N. RIVERSIDE DR ESPANOLA NM,Deposits,,115.13,,ATM Deposit CU ANYTIME 6011 1907 N. RIVERSIDE DR ESPANOLA NM
,6/7/2021,,Debit,-24.51,,33991154,CLYDES RV 5271 ESPANOLA NM,Restaurants & Dining,Debit Card,15.13,,Debit Card purchase CLYDES RV 5271 ESPANOLA NM
,6/5/2021,,Debit,-14.25,,33991111,Chevron,Gasoline/Fuel,Debit Card,39.64,,Debit Card purchase CHEVRON 0208520 5542 HERNANDEZ NM
,6/5/2021,,Debit,-13,,33991153,Champs Express Car Wash,Automotive Expenses,Debit Card,53.89,,Debit Card purchase CHAMPION XPRESS CAR WASH 7542 ESPANOLA NM
,6/5/2021,,Debit,-22.48,,33991152,Speedway,Gasoline/Fuel,Debit Card,66.89,,Debit Card purchase SPEEDWAY 09261 1616 N. RI 5542 ESPANOLA NM
,6/5/2021,,Debit,-23.57,,33991151,Speedway,Gasoline/Fuel,Debit Card,89.37,,Debit Card purchase SPEEDWAY 09135 1313 PASEO 5542 ESPANOLA NM
,6/4/2021,,Debit,-26.49,,33991110,Walmart,Shopping,Debit Card,112.94,,POS Card purchase WAL-MART SUPER CENTER 5411 2656 WAL-SAMS ESPANOLA NM
,6/4/2021,,Debit,-120.57,,33991109,Walmart,Shopping,Debit Card,139.43,,POS Card purchase WAL WAL-MART #2656 412028 5411 1610 N RIVERSIDE DR ESPANOLA NM
,6/4/2021,,Credit,260,,33991150,ATM Deposit CU ANYTIME XX 1907 N. RIVERSIDE DR ESPANOLA NM,Deposits,,260,,ATM Deposit CU ANYTIME 6011 1907 N. RIVERSIDE DR ESPANOLA NM
,6/4/2021,,Debit,-25.23,,33991149,Lowe's,Home Supplies,Debit Card,0,,Debit Card purchase LOWES #02510* 5200 ESPANOLA NM
,6/4/2021,,Debit,-89.63,,33991148,Lowe's,Home Supplies,Debit Card,25.23,,Debit Card purchase LOWES #02510* 5200 ESPANOLA NM
,6/4/2021,,Credit,2.33,,33991108,Deposit Transfer from SXX00 - Overdraft Transfer,Deposits,Transfer,114.86,,Deposit Transfer from S0000 - Overdraft Transfer
,6/2/2021,,Debit,-7.94,,33991107,McDonald's,Restaurants & Dining,Debit Card,112.53,,POS Card purchase MCDONALD'S F36782 5814 1401 N RIVERSIDE DR ESPANOLA NM
,6/1/2021,,Credit,100,,33991147,ACH Deposit COMPANY: VENMO ENTRY: CASHOUT ISAIAH MALCOM,Transfers,ACH,120.47,,ACH Deposit COMPANY: VENMO ENTRY: CASHOUT ISAIAH MALCOM
,5/31/2021,,Debit,-5.34,,33991106,Youtube Premium,Entertainment,,20.47,,Bill payment Withdrawal GOOGLE *YOUTUBE MEMBER 5968 650-253-0000 CA
,5/30/2021,,Debit,-23.02,,33991146,Steamgames,Entertainment,Debit Card,25.81,,Debit Card purchase STEAMGAMES.COM 4259522985 5816 425-8899642 WA
,5/30/2021,,Debit,-16.32,,33991145,Lowe's,Home Supplies,Debit Card,48.83,,Debit Card purchase LOWES #02510* 5200 ESPANOLA NM
,5/29/2021,,Credit,64,,33991144,Anytime Fitness Deposit,Deposits,,65.15,,ATM Deposit CU ANYTIME 6011 1216 PASO DE ONATE ESPANOLA NM
,5/29/2021,,Debit,-50,,33991105,Online banking Withdrawal Transfer to LXX00 - Internet Access 05/29/2021 09:18 x1272:,Transfers,Transfer,1.15,,Online banking Withdrawal Transfer to L0100 - Internet Access 05/29/2021 09:18 71272:
,5/28/2021,,Debit,-8.7,,33991143,Disney Plus,Entertainment,,51.15,,Bill payment Withdrawal DISNEYPLUS 4899 888-9057888 CA
,5/26/2021,,Credit,30.48,,33991104,AutoZone,Automotive Expenses,Debit Card,59.85,,Debit Card purchase return Adjustment AUTOZONE #2520 5533 ESPANOLA NM
,5/26/2021,,Debit,-19.06,,33991103,Starbucks,Restaurants & Dining,Debit Card,29.37,,Debit Card purchase STARBUCKS STORE 50626 5814 ESPANOLA NM
,5/26/2021,,Debit,-15.76,,33991102,Amazon Digital Services,Entertainment,Debit Card,48.43,,Debit Card purchase AMAZON DIGIT*2R27J8G10 5818 AMZN.COM/BILL WA
,5/26/2021,,Debit,-15.24,,33991142,Netflix,Entertainment,,64.19,,Bill payment Withdrawal NETFLIX COM 4899 LOS GATOS CA
,5/26/2021,,Debit,-25,,33991141,NMSU CASHNET XX-2046 NM,Clothing,Debit Card,79.43,,Debit Card purchase NMSU CASHNET 8220 575-646-2046 NM
,5/25/2021,,Debit,-31.55,,33991140,Lowe's,Home Supplies,Debit Card,104.43,,Debit Card purchase LOWES #02510* 5200 ESPANOLA NM
,5/25/2021,,Debit,-10.61,,33991139,Freddy's Frozen Custard & Steakburgers,Restaurants & Dining,Debit Card,135.98,,Debit Card purchase FREDDY'S 28-0005 5814 ESPANOLA NM
,5/24/2021,,Debit,-12.6,,33991138,Amazon,Shopping,,146.59,,Bill payment Withdrawal AMAZON.COM*2R0FE3S71 4816 SEATTLE WA
,5/24/2021,,Debit,-100,,33991101,Online banking Withdrawal Transfer to LXX00 - Internet Access 05/24/2021 15:28 x8283:,Transfers,Transfer,159.19,,Online banking Withdrawal Transfer to L0100 - Internet Access 05/24/2021 15:28 48283:
,5/24/2021,,Debit,-18.91,,33991100,Amazon,Shopping,,259.19,,Bill payment Withdrawal AMAZON.COM*2R5F61611 4816 SEATTLE WA
,5/24/2021,,Debit,-35.37,,33991046,AutoZone,Automotive Expenses,Debit Card,278.1,,Debit Card purchase AUTOZONE #2520 5533 ESPANOLA NM
,5/23/2021,,Debit,-10.5,,33991099,Spotify,Entertainment,,313.47,,Bill payment Withdrawal SPOTIFY USA 4899 877-7781161 NY
,5/22/2021,,Credit,147,,33991098,Anytime Fitness Deposit,Deposits,,323.97,,ATM Deposit CU ANYTIME 6011 1216 PASO DE ONATE ESPANOLA NM
,5/22/2021,,Debit,-13.66,,33991045,Amazon,Shopping,,176.97,,Bill payment Withdrawal AMAZON PRIME*2R39P7N60 5968 AMZN.COM/BILL WA
,5/21/2021,,Debit,-3.18,,33991097,Marathon Petroleum,Gasoline/Fuel,Debit Card,190.63,,Debit Card purchase MARATHON PETRO235069 5541 LEMITAR NM
,5/19/2021,,Debit,-10.67,,33991044,YouTube Music,Entertainment,,193.81,,Bill payment Withdrawal GOOGLE *YOUTUBE MUSIC 5968 650-253-0000 CA
,5/18/2021,,Debit,-15.45,,33991043,Sonic Drive-In,Restaurants & Dining,Debit Card,204.48,,Debit Card purchase SONIC DRIVE IN #1962 5814 ESPANOLA NM
,5/17/2021,,Debit,-6.4,,33991042,Funimation,Entertainment,,219.93,,Bill payment Withdrawal GOOGLE *FUNIMATION 5968 650-253-0000 CA
,5/17/2021,,Credit,105,,33991096,ACH Deposit COMPANY: VENMO ENTRY: CASHOUT ISAIAH MALCOM,Transfers,ACH,226.33,,ACH Deposit COMPANY: VENMO ENTRY: CASHOUT ISAIAH MALCOM
,5/17/2021,,Debit,-31.34,,33991041,Panda Express,Restaurants & Dining,Debit Card,121.33,,Debit Card purchase PANDA EXPRESS 862 5814 SANTA FE NM
,5/16/2021,,Debit,-32.68,,33991095,Great Clips,Personal Care & Fitness,Debit Card,152.67,,Debit Card purchase 0646 GREAT CLIPS AT ESPAN 7230 ESPANOLA NM
,5/15/2021,,Debit,-8.81,,33991040,Sonic Drive-In,Restaurants & Dining,Debit Card,185.35,,Debit Card purchase SONIC DRIVE IN #1982 5814 ESPANOLA NM
,5/15/2021,,Debit,-20.98,,33991039,McDonald's,Restaurants & Dining,Debit Card,194.16,,Debit Card purchase MCDONALD'S F36782 5814 ESPANOLA NM
,5/15/2021,,Debit,-46.22,,33991094,Harbor Freight Tools,Home Supplies,Debit Card,215.14,,Debit Card purchase HARBOR FREIGHT TOOLS2986 5251 CALABASAS CA
,5/14/2021,,Debit,-18.86,,33991093,El Parasol,Restaurants & Dining,Debit Card,261.36,,Debit Card purchase EL PARASOL 5812 ESPANOLA NM
,5/13/2021,,Debit,-7.68,,33991038,Starbucks,Restaurants & Dining,Debit Card,280.22,,Debit Card purchase STARBUCKS STORE 50626 5814 ESPANOLA NM
,5/13/2021,,Debit,-6.3,,33991037,Amazon Digital Services,Entertainment,Debit Card,287.9,,Debit Card purchase AMAZON DIGIT*2L8SA8P12 5818 AMZN.COM/BILL WA
,5/13/2021,,Debit,-8.7,,33991092,Harbor Freight Tools,Home Supplies,Debit Card,294.2,,Debit Card purchase HARBOR FREIGHT TOOLS2986 5251 CALABASAS CA
,5/12/2021,,Credit,285,,33991091,ACH Deposit COMPANY: VENMO ENTRY: CASHOUT ISAIAH MALCOM,Transfers,ACH,302.9,,ACH Deposit COMPANY: VENMO ENTRY: CASHOUT ISAIAH MALCOM
,5/12/2021,,Debit,-7,,33991090,Cashier,Education,Debit Card,17.9,,Debit Card purchase NNMC - CASHIER 8220 505-7475050 NM
,5/9/2021,,Debit,-53.63,,33991036,Walmart,Shopping,Debit Card,24.9,,POS Card purchase WAL-MART #2656 5411 1610 N RIVERSIDE DR ESPANOLA NM
,5/9/2021,,Debit,-9.45,,33991089,Amazon Digital Services,Entertainment,Debit Card,78.53,,Debit Card purchase PRIME VIDEO*2L83L1BK1 5818 888-802-3080 WA
,5/7/2021,,Debit,-3.54,,33991035,Starbucks,Restaurants & Dining,Debit Card,87.98,,Debit Card purchase STARBUCKS STORE 50626 5814 ESPANOLA NM
,5/7/2021,,Debit,-8.66,,33991034,Starbucks,Restaurants & Dining,Debit Card,91.52,,Debit Card purchase STARBUCKS STORE 50626 5814 ESPANOLA NM
,5/6/2021,,Debit,-43.01,,33991033,AutoZone,Automotive Expenses,Debit Card,100.18,,Debit Card purchase AUTOZONE #2520 5533 ESPANOLA NM
,5/3/2021,,Debit,-13.4,,33991032,Starbucks,Restaurants & Dining,Debit Card,143.19,,Debit Card purchase STARBUCKS STORE 50626 5814 ESPANOLA NM
,5/3/2021,,Debit,-20.79,,33991088,Freddy's Frozen Custard & Steakburgers,Restaurants & Dining,Debit Card,156.59,,Debit Card purchase FREDDY'S 28-0005 5814 ESPANOLA NM
,5/2/2021,,Debit,-5.66,,33991031,Walmart,Shopping,Debit Card,177.38,,POS Card purchase WM SUPERCENTER # 5411 WAL-MART SUPER CENTER ESPANOLA NM
,5/1/2021,,Debit,-9.37,,33991030,Starbucks,Restaurants & Dining,Debit Card,183.04,,Debit Card purchase STARBUCKS STORE 50626 5814 ESPANOLA NM
,5/1/2021,,Debit,-5.34,,33991029,Youtube Premium,Entertainment,,192.41,,Bill payment Withdrawal GOOGLE *YOUTUBE MEMBER 5968 650-253-0000 CA
,4/28/2021,,Debit,-8.7,,33991087,Disney Plus,Entertainment,,197.75,,Bill payment Withdrawal DISNEYPLUS 4899 888-9057888 CA
,4/27/2021,,Debit,-4.19,,33991086,Steamgames,Entertainment,Debit Card,206.45,,Debit Card purchase STEAMGAMES.COM 4259522985 5816 425-8899642 WA
,4/27/2021,,Debit,-17.36,,33991085,Lowe's,Home Supplies,Debit Card,210.64,,Debit Card purchase LOWES #02510* 5200 ESPANOLA NM
,4/27/2021,,Debit,-18.91,,33991084,Amazon,Shopping,,228,,Bill payment Withdrawal AMAZON.COM*0O3A42MO3 4816 SEATTLE WA
,4/26/2021,,Debit,-15.24,,33991028,Netflix,Entertainment,,246.91,,Bill payment Withdrawal NETFLIX.COM 4899 NETFLIX.COM CA
,4/26/2021,,Credit,200,,33991083,ACH Deposit COMPANY: VENMO ENTRY: CASHOUT ISAIAH MALCOM,Transfers,ACH,262.15,,ACH Deposit COMPANY: VENMO ENTRY: CASHOUT ISAIAH MALCOM
,4/26/2021,,Debit,-10.5,,33991082,Spotify,Entertainment,,62.15,,Bill payment Withdrawal SPOTIFY USA 4899 877-7781161 NY
,4/26/2021,,Debit,-15.76,,33991081,Amazon Digital Services,Entertainment,Debit Card,72.65,,Debit Card purchase AMZN DIGITAL*Q809J5L43 88 5818 888-802-3080 WA
,4/25/2021,,Debit,-13.29,,33991027,Starbucks,Restaurants & Dining,Debit Card,88.41,,Debit Card purchase STARBUCKS STORE 50626 5814 ESPANOLA NM
,4/25/2021,,Debit,-5.43,,33991080,Lowe's,Home Supplies,Debit Card,101.7,,Debit Card purchase LOWES #02510* 5200 ESPANOLA NM
,4/24/2021,,Debit,-18.91,,33991079,Amazon,Shopping,,107.13,,Bill payment Withdrawal AMAZON.COM*256O83LT3 4816 SEATTLE WA
,4/24/2021,,Debit,-600,,33991026,Online banking Withdrawal Transfer to LXX00 - Internet Access 04/24/2021 02:53 XX1084:,Transfers,Transfer,126.04,,Online banking Withdrawal Transfer to L0100 - Internet Access 04/24/2021 02:53 901084:
,4/23/2021,,Credit,726,,33991078,ACH Deposit COMPANY: NORTHERN NEW MEX ENTRY: ACH PAYMEN ISAIAH J. MALCOM,Deposits,ACH,726.04,,ACH Deposit COMPANY: NORTHERN NEW MEX ENTRY: ACH PAYMEN ISAIAH J. MALCOM
,4/20/2021,,Debit,-5.39,,33991025,Starbucks,Restaurants & Dining,Debit Card,0.04,,Debit Card purchase STARBUCKS STORE 50626 5814 ESPANOLA NM
,4/19/2021,,Debit,-10.67,,33991024,YouTube Music,Entertainment,,5.43,,Bill payment Withdrawal GOOGLE *YOUTUBE MUSIC 5968 650-253-0000 CA
,4/19/2021,,Debit,-5.43,,33991077,Lowe's,Home Supplies,Debit Card,16.1,,Debit Card purchase LOWES #02510* 5200 ESPANOLA NM
,4/19/2021,,Debit,-120,,33991076,ATM Withdrawal CU ANYTIME XX 1216 PASO DE ONATE ESPANOLA NM,ATM/Cash Withdrawals,Debit Card,21.53,,ATM Withdrawal CU ANYTIME 6011 1216 PASO DE ONATE ESPANOLA NM
,4/17/2021,,Debit,-6.4,,33991023,Funimation,Entertainment,,141.53,,Bill payment Withdrawal GOOGLE *FUNIMATION 5968 650-253-0000 CA
,4/17/2021,,Debit,-47.15,,33991075,MEYERS STEEL 5085 ESPANOLA NM,Restaurants & Dining,Debit Card,147.93,,Debit Card purchase MEYERS STEEL 5085 ESPANOLA NM
,4/16/2021,,Credit,109.6,,33991074,ACH Deposit COMPANY: NORTHERN NEW MEX ENTRY: ACH PAYMEN ISAIAH J. MALCOM,Deposits,ACH,195.08,,ACH Deposit COMPANY: NORTHERN NEW MEX ENTRY: ACH PAYMEN ISAIAH J. MALCOM
,4/13/2021,,Debit,-6.3,,33991022,Amazon Digital Services,Entertainment,Debit Card,85.48,,Debit Card purchase AMAZON DIGIT*L29325503 5818 AMZN.COM/BILL WA
,4/12/2021,,Debit,-34.91,,33991073,Speedway,Gasoline/Fuel,Debit Card,91.78,,Debit Card purchase SPEEDWAY 09135 1313 PASEO 5542 ESPANOLA NM
,4/11/2021,,Debit,-216.34,,33991021,Walmart,Shopping,Debit Card,126.69,,POS Card purchase WAL WAL-MART #2656 710887 5411 1610 N RIVERSIDE DR ESPANOLA NM
,4/11/2021,,Credit,60,,33991072,ATM Deposit CU ANYTIME XX 1907 N. RIVERSIDE DR ESPANOLA NM,Deposits,,343.03,,ATM Deposit CU ANYTIME 6011 1907 N. RIVERSIDE DR ESPANOLA NM
,4/11/2021,,Credit,50,,33991071,ATM Deposit CU ANYTIME XX 1907 N. RIVERSIDE DR ESPANOLA NM,Deposits,,283.03,,ATM Deposit CU ANYTIME 6011 1907 N. RIVERSIDE DR ESPANOLA NM
,4/11/2021,,Debit,-7.83,,33991020,McDonald's,Restaurants & Dining,Debit Card,233.03,,POS Card purchase MCDONALD'S F36782 5814 1401 N RIVERSIDE DR ESPANOLA NM
,4/11/2021,,Debit,-3.76,,33991019,Starbucks,Restaurants & Dining,Debit Card,240.86,,Debit Card purchase STARBUCKS STORE 50626 5814 ESPANOLA NM
,4/10/2021,,Debit,-29.1,,33991070,Amazon,Shopping,,244.62,,Bill payment Withdrawal AMAZON.COM*142Q35E23 4816 SEATTLE WA
,4/10/2021,,Debit,-14.21,,33991069,Amazon,Shopping,,273.72,,Bill payment Withdrawal AMAZON.COM*UR1AO6HU3 4816 SEATTLE WA
,4/10/2021,,Debit,-4.34,,33991068,Lowe's,Home Supplies,Debit Card,287.93,,Debit Card purchase LOWES #02510* 5200 ESPANOLA NM
,4/10/2021,,Debit,-18.91,,33991067,Amazon,Shopping,,292.27,,Bill payment Withdrawal AMAZON.COM*O03EX1KE3 4816 SEATTLE WA
,4/10/2021,,Debit,-9.45,,33991066,Amazon Digital Services,Entertainment,Debit Card,311.18,,Debit Card purchase PRIME VIDEO*6E3CJ3T73 5818 888-802-3080 WA
,4/9/2021,,Debit,-18.25,,33991018,Starbucks,Restaurants & Dining,Debit Card,320.63,,Debit Card purchase STARBUCKS STORE 50626 5814 ESPANOLA NM
,4/9/2021,,Debit,-26.08,,33991065,Harbor Freight Tools,Home Supplies,Debit Card,338.88,,Debit Card purchase HARBOR FREIGHT TOOLS2986 5251 CALABASAS CA
,4/8/2021,,Debit,-23.17,,33991017,McDonald's,Restaurants & Dining,Debit Card,364.96,,Debit Card purchase MCDONALD'S F36782 5814 ESPANOLA NM
,4/7/2021,,Debit,-43.47,,33991064,Harbor Freight Tools,Home Supplies,Debit Card,388.13,,Debit Card purchase HARBOR FREIGHT TOOLS2986 5251 CALABASAS CA
,4/6/2021,,Debit,-33.52,,33991063,Hobby Lobby,Hobbies,Debit Card,431.6,,Debit Card purchase HOBBY-LOBBY #0078 5945 SANTA FE NM
,4/6/2021,,Debit,-33.21,,33991016,Walmart,Shopping,Debit Card,465.12,,POS Card purchase WAL-MART #2656 5411 1610 NO. RIVERSIDE DRIV ESPANOLA NM
,4/6/2021,,Debit,-77.85,,33991062,ARROYO SECO ANIMAL HOSPIT 0742 ESPANOLA NM,Pets,Debit Card,498.33,,Debit Card purchase ARROYO SECO ANIMAL HOSPIT 0742 ESPANOLA NM
,4/5/2021,,Debit,-148.02,,33991061,Sam's Club,Shopping,Debit Card,576.18,,POS Card purchase WAL SAMSCLUB #6408 212511 5300 4201 RODEO ROAD SANTA FE NM
,4/5/2021,,Credit,500,,33991015,Online banking Deposit Transfer from SXX00 - Internet Access 04/05/2021 11:06 XX4492:,Deposits,Transfer,724.2,,Online banking Deposit Transfer from S0000 - Internet Access 04/05/2021 11:06 804492:
,4/5/2021,,Credit,200,,33991014,Online banking Deposit Transfer from SXX00 - Internet Access 04/05/2021 08:47 XX3644:,Deposits,Transfer,224.2,,Online banking Deposit Transfer from S0000 - Internet Access 04/05/2021 08:47 803644:
,4/4/2021,,Debit,-10.61,,33991060,Freddy's Frozen Custard & Steakburgers,Restaurants & Dining,Debit Card,24.2,,Debit Card purchase FREDDY'S 28-0005 5814 ESPANOLA NM
,4/2/2021,,Debit,-14,,33991059,Facebook,Online Services,Debit Card,34.81,,Debit Card purchase FACEBK KJDQX33YH2 7311 650-5434800 CA
,4/2/2021,,Credit,40,,33991013,Online banking Deposit Transfer from SXX00 - Internet Access 04/02/2021 06:05 XX2038:,Deposits,Transfer,48.81,,Online banking Deposit Transfer from S0000 - Internet Access 04/02/2021 06:05 792038:
,4/2/2021,,Debit,-13.17,,33991058,Withdrawal XENOWARE XX3879 NY,Clothing,,8.81,,Bill payment Withdrawal XENOWARE 7311 844-6593879 NY
,4/1/2021,,Debit,-7.68,,33991012,Starbucks,Restaurants & Dining,Debit Card,21.98,,Debit Card purchase STARBUCKS STORE 50626 5814 ESPANOLA NM
,4/1/2021,,Debit,-393.21,,33991057,Harbor Freight Tools,Home Supplies,Debit Card,29.66,,Debit Card purchase HARBOR FREIGHT TOOLS2986 5251 CALABASAS CA
,3/31/2021,,Debit,-5.34,,33991011,Youtube Premium,Entertainment,,422.87,,Bill payment Withdrawal GOOGLE *YOUTUBE MEMBER 5968 650-253-0000 CA
,3/31/2021,,Credit,316.8,,33991056,Transfer from Venmo,Transfers,,428.21,,Debit Deposit VENMO*MALCOM ISAIAH 4829 NEW YORK CITY NY
,3/31/2021,,Debit,-15.24,,33991055,Harbor Freight Tools,Home Supplies,Debit Card,111.41,,Debit Card purchase HARBOR FREIGHT TOOLS2986 5251 CALABASAS CA
,3/30/2021,,Debit,-9.13,,33991010,Sonic Drive-In,Restaurants & Dining,Debit Card,126.65,,Debit Card purchase SONIC DRIVE IN #1982 5814 ESPANOLA NM
,3/30/2021,,Debit,-3.24,,33991009,Walmart,Shopping,Debit Card,135.78,,POS Card purchase WM SUPERCENTER # 5411 WAL-MART SUPER CENTER ESPANOLA NM
,3/30/2021,,Debit,-56.35,,33991008,Walmart,Shopping,Debit Card,139.02,,POS Card purchase WAL-MART #2656 5411 1610 N RIVERSIDE DR ESPANOLA NM
,3/30/2021,,Credit,120,,33991007,Online banking Deposit Transfer from SXX00 - Internet Access 03/30/2021 19:10 XX7454:,Deposits,Transfer,195.37,,Online banking Deposit Transfer from S0000 - Internet Access 03/30/2021 19:10 777454:
,3/29/2021,,Debit,-5.39,,33991006,Starbucks,Restaurants & Dining,Debit Card,75.37,,Debit Card purchase STARBUCKS STORE 50626 5814 ESPANOLA NM
,3/29/2021,,Debit,-31.62,,33991054,Speedway,Gasoline/Fuel,Debit Card,80.76,,Debit Card purchase SPEEDWAY 09132 1225 PASEO 5542 ESPANOLA NM
,3/28/2021,,Debit,-7.68,,33991005,Starbucks,Restaurants & Dining,Debit Card,112.38,,Debit Card purchase STARBUCKS STORE 50626 5814 ESPANOLA NM
,3/28/2021,,Debit,-22.13,,33991053,Dollar General,Shopping,Debit Card,120.06,,POS Card purchase DOLLAR GENERAL # 5310 4 DEL SOL LANE HERNANDEZ NM
,3/28/2021,,Credit,100,,33991004,Online banking Deposit Transfer from SXX00 - Internet Access 03/28/2021 16:03 XX7168:,Deposits,Transfer,142.19,,Online banking Deposit Transfer from S0000 - Internet Access 03/28/2021 16:03 767168:
,3/28/2021,,Debit,-189.48,,33991052,Harbor Freight Tools,Home Supplies,Debit Card,42.19,,Debit Card purchase HARBOR FREIGHT TOOLS2986 5251 CALABASAS CA
,3/28/2021,,Debit,-8.7,,33991051,Disney Plus,Entertainment,,231.67,,Bill payment Withdrawal DISNEYPLUS 4899 888-9057888 CA
,3/27/2021,,Debit,-56.56,,33991003,Walmart,Shopping,Debit Card,240.37,,POS Card purchase WAL-MART #2656 5411 1610 N RIVERSIDE DR ESPANOLA NM
,3/26/2021,,Debit,-15.76,,33991002,Amazon Digital Services,Entertainment,Debit Card,296.93,,Debit Card purchase AMAZON DIGIT*EV0H951W3 5818 AMZN.COM/BILL WA
,3/26/2021,,Credit,140,,33991050,ACH Deposit COMPANY: VENMO ENTRY: CASHOUT ISAIAH MALCOM,Transfers,ACH,312.69,,ACH Deposit COMPANY: VENMO ENTRY: CASHOUT ISAIAH MALCOM
,3/26/2021,,Debit,-52.55,,33991049,Steamgames,Entertainment,Debit Card,172.69,,Debit Card purchase STEAMGAMES.COM 4259522985 5816 425-8899642 WA
,3/25/2021,,Debit,-15.76,,33991048,Steam,Entertainment,Debit Card,225.24,,Debit Card purchase STEAM PURCHASE 5816 425-9522985 WA
,3/24/2021,,Debit,-10.82,,33991001,Wendy's,Restaurants & Dining,Debit Card,241,,POS Card purchase WENDYS #12097 5814 3151 CERRILLOS RD SANTA FE NM
,3/23/2021,,Debit,-26.28,,33991047,Turbotax,Online Services,Debit Card,251.82,,Debit Card purchase INTUIT *TURBOTAX 5734 800-446-8848 CA
,3/23/2021,,Debit,-5.39,,33990947,Starbucks,Restaurants & Dining,Debit Card,278.1,,Debit Card purchase STARBUCKS STORE 50626 5814 ESPANOLA NM
,3/23/2021,,Debit,-70,,33990946,Online banking Withdrawal Transfer to LXX00 - Internet Access 03/23/2021 17:27 XX1596:,Transfers,Transfer,283.49,,Online banking Withdrawal Transfer to L0100 - Internet Access 03/23/2021 17:27 741596:
,3/23/2021,,Debit,-240.09,,33991000,Lowe's,Home Supplies,Debit Card,353.49,,Debit Card purchase LOWES #02510* 5200 ESPANOLA NM
,3/23/2021,,Debit,-10.5,,33990999,Spotify,Entertainment,,593.58,,Bill payment Withdrawal SPOTIFY USA 4899 877-7781161 NY
,3/22/2021,,Credit,500,,33990998,ATM Deposit CU ANYTIME XX 1907 N. RIVERSIDE DR ESPANOLA NM,Deposits,,604.08,,ATM Deposit CU ANYTIME 6011 1907 N. RIVERSIDE DR ESPANOLA NM
,3/22/2021,,Credit,100,,33990997,ACH Deposit COMPANY: VENMO ENTRY: CASHOUT ISAIAH MALCOM,Transfers,ACH,104.08,,ACH Deposit COMPANY: VENMO ENTRY: CASHOUT ISAIAH MALCOM
,3/19/2021,,Debit,-10.67,,33990945,YouTube Music,Entertainment,,4.08,,Bill payment Withdrawal GOOGLE *YOUTUBE MUSIC 5968 650-253-0000 CA
,3/19/2021,,Debit,-63.43,,33990996,Speedway,Gasoline/Fuel,Debit Card,14.75,,Debit Card purchase SPEEDWAY 09132 1225 PASEO 5542 ESPANOLA NM
,3/19/2021,,Debit,-38.55,,33990995,El Parasol,Restaurants & Dining,Debit Card,78.18,,Debit Card purchase EL PARASOL 5812 ESPANOLA NM
,3/16/2021,,Debit,-5.39,,33990944,Starbucks,Restaurants & Dining,Debit Card,116.73,,Debit Card purchase STARBUCKS STORE 50626 5814 ESPANOLA NM
,3/16/2021,,Debit,-5.25,,33990994,Steamgames,Entertainment,Debit Card,122.12,,Debit Card purchase STEAMGAMES.COM 4259522985 5816 425-8899642 WA
,3/15/2021,,Credit,120,,33990993,ATM Deposit CU ANYTIME XX 1907 N. RIVERSIDE DR ESPANOLA NM,Deposits,,127.37,,ATM Deposit CU ANYTIME 6011 1907 N. RIVERSIDE DR ESPANOLA NM
,3/14/2021,,Credit,5,,33990943,Online banking Deposit Transfer from SXX00 - Internet Access 03/14/2021 22:20 XX9652:,Deposits,Transfer,7.37,,Online banking Deposit Transfer from S0000 - Internet Access 03/14/2021 22:20 689652:
,3/13/2021,,Debit,-5.39,,33990942,Starbucks,Restaurants & Dining,Debit Card,2.37,,Debit Card purchase STARBUCKS STORE 50626 5814 ESPANOLA NM
,3/13/2021,,Debit,-6.3,,33990941,Amazon Digital Services,Entertainment,Debit Card,7.76,,Debit Card purchase AMAZON DIGIT*509F93NG3 5818 AMZN.COM/BILL WA
,,,,,,,,,,,,
,3/11/2021,,Debit,-21.74,,33990992,Amazon,Shopping,,22.6,,Bill payment Withdrawal AMAZON.COM*7F0EI9UR3 4816 SEATTLE WA
,3/9/2021,,Debit,-9.45,,33990991,Amazon Digital Services,Entertainment,Debit Card,44.34,,Debit Card purchase PRIME VIDEO*3W2NC9JH3 5818 888-802-3080 WA
,3/8/2021,,Credit,40,,33990990,ACH Deposit COMPANY: VENMO ENTRY: CASHOUT ISAIAH MALCOM,Transfers,ACH,53.79,,ACH Deposit COMPANY: VENMO ENTRY: CASHOUT ISAIAH MALCOM
,3/7/2021,,Debit,-7.18,,33990939,McDonald's,Restaurants & Dining,Debit Card,13.79,,POS Card purchase MCDONALD'S F36782 5814 1401 N RIVERSIDE DR ESPANOLA NM
,3/6/2021,,Debit,-3.76,,33990938,Starbucks,Restaurants & Dining,Debit Card,20.97,,Debit Card purchase STARBUCKS STORE 50626 5814 ESPANOLA NM
,3/6/2021,,Debit,-31.53,,33990937,Amazon Digital Services,Entertainment,Debit Card,24.73,,Debit Card purchase AMAZON DIGIT*CS8DM1VJ3 5818 AMZN.COM/BILL WA
,3/4/2021,,Debit,-13.66,,33990989,Amazon,Shopping,,56.26,,Bill payment Withdrawal AMAZON.COM*894KA7AD3 4816 SEATTLE WA
,3/4/2021,,Debit,-32,,33990936,Online banking Withdrawal Transfer to LXX00 - Internet Access 03/04/2021 00:13 XX8037:,Transfers,Transfer,69.92,,Online banking Withdrawal Transfer to L0100 - Internet Access 03/04/2021 00:13 638037:
,3/3/2021,,Credit,63,,33990988,ATM Deposit CU ANYTIME XX 1907 N. RIVERSIDE DR ESPANOLA NM,Deposits,,101.92,,ATM Deposit CU ANYTIME 6011 1907 N. RIVERSIDE DR ESPANOLA NM
,3/2/2021,,Debit,-0.2,,33990987,XENOWARE XX3879 NY,Clothing,Debit Card,38.92,,Debit Card purchase XENOWARE 7311 844-6593879 NY
,3/1/2021,,Debit,-5.34,,33990935,Youtube Premium,Entertainment,,39.12,,Bill payment Withdrawal GOOGLE *YOUTUBE MEMBER 5968 650-253-0000 CA
,3/1/2021,,Credit,40,,33990986,ACH Deposit COMPANY: VENMO ENTRY: CASHOUT ISAIAH MALCOM,Transfers,ACH,44.46,,ACH Deposit COMPANY: VENMO ENTRY: CASHOUT ISAIAH MALCOM
,2/28/2021,,Debit,-7.61,,33990985,Disney Plus,Entertainment,,4.46,,Bill payment Withdrawal DISNEYPLUS 5815 888-9057888 CA
,2/26/2021,,Debit,-15.76,,33990934,Amazon Digital Services,Entertainment,Debit Card,12.07,,Debit Card purchase AMAZON DIGIT*V84NL7ZC3 5818 AMZN.COM/BILL WA
,2/25/2021,,Debit,-29.49,,33990984,Speedway,Gasoline/Fuel,Debit Card,27.83,,Debit Card purchase SPEEDWAY 09309 4354 CERRI 5542 SANTA FE NM
,2/23/2021,,Debit,-10.5,,33990983,Spotify,Entertainment,,57.32,,Bill payment Withdrawal SPOTIFY USA 4899 877-7781161 NY
,2/22/2021,,Debit,-13.66,,33990933,Amazon,Shopping,,67.82,,Bill payment Withdrawal AMAZON PRIME*PT1XE5MV3 5968 AMZN.COM/BILL WA
,2/21/2021,,Debit,-10.67,,33990932,YouTube Music,Entertainment,,81.48,,Bill payment Withdrawal GOOGLE *YOUTUBE MUSIC 5968 650-253-0000 CA
,2/20/2021,,Credit,90,,33990982,ATM Deposit CU ANYTIME XX 1907 N. RIVERSIDE DR ESPANOLA NM,Deposits,,92.15,,ATM Deposit CU ANYTIME 6011 1907 N. RIVERSIDE DR ESPANOLA NM
,2/18/2021,,Debit,-5.39,,33990931,Starbucks,Restaurants & Dining,Debit Card,2.15,,Debit Card purchase STARBUCKS STORE 50626 5814 ESPANOLA NM
,2/17/2021,,Debit,-89.72,,33990930,The Home Depot,Home Supplies,Debit Card,7.54,,POS Card purchase THE HOME DEPOT #3503 5200 952 RICHARDS AVE. SANTA FE NM
,2/16/2021,,Debit,-14.71,,33990981,Amazon,Shopping,,97.26,,Bill payment Withdrawal AMAZON.COM*5795H6TY3 4816 SEATTLE WA
,2/16/2021,,Debit,-157.68,,33990980,Amazon,Shopping,,111.97,,Bill payment Withdrawal AMAZON.COM*5H7UB1F33 4816 SEATTLE WA
,2/14/2021,,Debit,-23.15,,33990979,Lowe's,Home Supplies,Debit Card,269.65,,Debit Card purchase LOWES #02510* 5200 ESPANOLA NM
,2/13/2021,,Credit,290,,33990978,ATM Deposit CU ANYTIME XX 1907 N. RIVERSIDE DR ESPANOLA NM,Deposits,,292.8,,ATM Deposit CU ANYTIME 6011 1907 N. RIVERSIDE DR ESPANOLA NM
,2/13/2021,,Debit,-6.3,,33990929,Amazon Digital Services,Entertainment,Debit Card,2.8,,Debit Card purchase AMAZON DIGIT*I43A99Y33 5818 AMZN.COM/BILL WA
,,,,,,,,,,,,
,2/11/2021,,Debit,-7.68,,33990927,Starbucks,Restaurants & Dining,Debit Card,17.64,,Debit Card purchase STARBUCKS STORE 50626 5814 ESPANOLA NM
,2/11/2021,,Debit,-10.88,,33990977,Harbor Freight Tools,Home Supplies,Debit Card,25.32,,Debit Card purchase HARBOR FREIGHT TOOLS2986 5251 CALABASAS CA
,2/11/2021,,Debit,-62.06,,33990976,Harbor Freight Tools,Home Supplies,Debit Card,36.2,,Debit Card purchase HARBOR FREIGHT TOOLS2986 5251 CALABASAS CA
,2/10/2021,,Credit,60,,33990975,ATM Deposit CU ANYTIME XX 1907 N. RIVERSIDE DR ESPANOLA NM,Deposits,,98.26,,ATM Deposit CU ANYTIME 6011 1907 N. RIVERSIDE DR ESPANOLA NM
,2/10/2021,,Debit,-30,,33990926,Online banking Withdrawal Transfer to LXX00 - Internet Access 02/09/2021 23:02 XX9717:,Transfers,Transfer,38.26,,Online banking Withdrawal Transfer to L0100 - Internet Access 02/09/2021 23:02 529717:
,2/10/2021,,Credit,20,,33990925,Online banking Deposit Transfer from SXX00 - Internet Access 02/09/2021 23:01 XX9715:,Deposits,Transfer,68.26,,Online banking Deposit Transfer from S0000 - Internet Access 02/09/2021 23:01 529715:
,2/9/2021,,Debit,-35.7,,33990974,Amazon,Shopping,,48.26,,Bill payment Withdrawal AMAZON.COM*VN0MO79A3 4816 SEATTLE WA
,2/9/2021,,Debit,-36.19,,33990973,Digi-key Electronics,Electronics & Equipment,Debit Card,83.96,,Debit Card purchase DKC*DIGI KEY CORP 5065 800-344-4539 MN
,2/7/2021,,Debit,-27.48,,33990972,Lowe's,Home Supplies,Debit Card,120.15,,Debit Card purchase LOWES #02510* 5200 ESPANOLA NM
,2/7/2021,,Debit,-66.18,,33990971,Amazon,Shopping,,147.63,,Bill payment Withdrawal AMAZON.COM*SO5PF6B53 4816 SEATTLE WA
,2/6/2021,,Credit,140,,33990970,ATM Deposit CU ANYTIME XX 1907 N. RIVERSIDE DR ESPANOLA NM,Deposits,,213.81,,ATM Deposit CU ANYTIME 6011 1907 N. RIVERSIDE DR ESPANOLA NM
,2/3/2021,,Debit,-7.72,,33990924,McDonald's,Restaurants & Dining,Debit Card,73.81,,POS Card purchase MCDONALD'S F36782 5814 1401 N RIVERSIDE DR ESPANOLA NM
,2/2/2021,,Debit,-8.21,,33990923,Taco Bell,Restaurants & Dining,Debit Card,81.53,,Debit Card purchase TACO BELL 26760 5814 SANTA FE NM
,2/1/2021,,Debit,-38.97,,33990922,The Home Depot,Home Supplies,Debit Card,89.74,,POS Card purchase THE HOME DEPOT #3503 5200 952 RICHARDS AVE. SANTA FE NM
,2/1/2021,,Debit,-48.1,,33990969,Lowe's,Home Supplies,Debit Card,128.71,,POS Card purchase LOWES MARK 5542 930 N RIVERSIDE DR ESPANOLA NM
,2/1/2021,,Credit,175,,33990968,ATM Deposit CU ANYTIME XX 1907 N. RIVERSIDE DR ESPANOLA NM,Deposits,,176.81,,ATM Deposit CU ANYTIME 6011 1907 N. RIVERSIDE DR ESPANOLA NM
,1/31/2021,,Debit,-5.34,,33990921,Youtube Premium,Entertainment,,1.81,,Bill payment Withdrawal GOOGLE *YOUTUBE MEMBER 5968 650-253-0000 CA
,1/29/2021,,Debit,-7.61,,33990967,Disney Plus,Entertainment,,7.15,,Bill payment Withdrawal DISNEYPLUS 5815 888-9057888 CA
,1/29/2021,,Debit,-8.68,,33990920,Panda Express,Restaurants & Dining,Debit Card,14.76,,Debit Card purchase PANDA EXPRESS 862 5814 SANTA FE NM
,1/29/2021,,Debit,-26.4,,33990966,PUYE CLIFFS WELCOME CENT 5542 ESPANOLA NM,Travel & Commute,Debit Card,23.44,,Debit Card purchase PUYE CLIFFS WELCOME CENT 5542 ESPANOLA NM
,1/29/2021,,Debit,-60.41,,33990919,Market Street,Groceries,Debit Card,49.84,,Debit Card purchase MARKET STREET 927 5411 SANTA FE NM
,1/29/2021,,Debit,-18.86,,33990965,El Parasol,Restaurants & Dining,Debit Card,110.25,,Debit Card purchase EL PARASOL 5812 ESPANOLA NM
,1/28/2021,,Debit,-5.39,,33990918,Starbucks,Restaurants & Dining,Debit Card,129.11,,Debit Card purchase STARBUCKS STORE 50626 5814 ESPANOLA NM
,1/26/2021,,Debit,-15.76,,33990917,Amazon Digital Services,Entertainment,Debit Card,134.5,,Debit Card purchase AMAZON DIGIT*9H4JW6733 5818 AMZN.COM/BILL WA
